Municipio,Depto,Censo electoral ,Participacion,Abstencion,Ganador,Votos Validos,Duque,Petro,Voto en Blanco,Nulos ,Tarjetones No Marcados,Votos invalidos
Medellín,Antioquia,1588150,979252,608898,Ivan Duque,965392,698505,207642,59245,1052,12808,13860
Abejorral,Antioquia,14967,7397,7570,Ivan Duque,7293,6572,547,174,36,68,104
Abriaquí,Antioquia,1913,1056,857,Ivan Duque,1045,975,43,27,10,1,11
Alejandría,Antioquia,4549,2343,2206,Ivan Duque,2318,2018,216,84,11,14,25
Amagá,Antioquia,22350,10755,11595,Ivan Duque,10507,8192,1706,609,26,222,248
Amalfi,Antioquia,17182,6394,10788,Ivan Duque,6279,5162,760,357,23,92,115
Andes,Antioquia,34753,16896,17857,Ivan Duque,16684,14161,2020,503,28,184,212
Angelópolis,Antioquia,5812,2777,3035,Ivan Duque,2741,2384,268,89,10,26,36
Angostura,Antioquia,9079,3340,5739,Ivan Duque,3229,2810,276,143,25,86,111
Anorí,Antioquia,11628,3325,8303,Ivan Duque,3263,2217,826,220,24,38,62
Santafé de Antioquia,Antioquia,20540,10277,10263,Ivan Duque,10018,7737,1770,511,56,203,259
Anzá,Antioquia,5771,2918,2853,Ivan Duque,2884,2609,201,74,11,23,34
Apartadó,Antioquia,92620,43518,49102,Gustavo Petro,42848,19443,21476,1929,85,585,670
Arboletes,Antioquia,22416,11172,11244,Ivan Duque,11039,6755,4117,167,32,101,133
Argelia,Antioquia,6570,3334,3236,Ivan Duque,3312,3124,134,54,7,15,22
Armenia,Antioquia,4688,2068,2620,Ivan Duque,2022,1739,215,68,9,37,46
Barbosa,Antioquia,40499,20721,19778,Ivan Duque,20130,14540,4371,1219,67,524,591
Belmira,Antioquia,4750,2269,2481,Ivan Duque,2226,1904,222,100,11,32,43
Bello,Antioquia,331836,179912,151924,Ivan Duque,176553,123720,41733,11100,216,3143,3359
Betania,Antioquia,8342,3550,4792,Ivan Duque,3516,3161,287,68,12,22,34
Betulia,Antioquia,13332,6484,6848,Ivan Duque,6402,5984,295,123,23,59,82
Ciudad Bolívar,Antioquia,23836,11663,12173,Ivan Duque,11543,10044,1161,338,27,93,120
Briceño,Antioquia,6610,2213,4397,Ivan Duque,2119,1360,603,156,32,62,94
Buriticá,Antioquia,7299,2930,4369,Ivan Duque,2849,2211,518,120,24,57,81
Cáceres,Antioquia,19548,5553,13995,Ivan Duque,5459,2853,2462,144,23,71,94
Caicedo,Antioquia,6267,3125,3142,Ivan Duque,3078,2659,325,94,13,34,47
Caldas,Antioquia,63501,37414,26087,Ivan Duque,36197,24691,8582,2924,70,1147,1217
Campamento,Antioquia,6625,1934,4691,Ivan Duque,1902,1581,252,69,9,23,32
Cañasgordas,Antioquia,13434,7262,6172,Ivan Duque,7147,6434,521,192,23,92,115
Caracolí,Antioquia,4710,1854,2856,Ivan Duque,1829,1448,298,83,4,21,25
Caramanta,Antioquia,4992,2432,2560,Ivan Duque,2392,1947,352,93,7,33,40
Carepa,Antioquia,42614,18313,24301,Ivan Duque,17990,8810,8472,708,44,279,323
El Carmen de Viboral,Antioquia,36226,24456,11770,Ivan Duque,23952,17321,5351,1280,65,439,504
Carolina,Antioquia,4049,1902,2147,Ivan Duque,1861,1515,239,107,2,39,41
Caucasia,Antioquia,68594,29938,38656,Ivan Duque,29291,16146,12072,1073,73,574,647
Chigorodó,Antioquia,46034,19553,26481,Gustavo Petro,19155,9157,9241,757,59,339,398
Cisneros,Antioquia,11528,5039,6489,Ivan Duque,4919,3881,764,274,24,96,120
Cocorná,Antioquia,13259,7814,5445,Ivan Duque,7741,6949,628,164,19,54,73
Concepción,Antioquia,4294,2329,1965,Ivan Duque,2303,2074,168,61,9,17,26
Concordia,Antioquia,15881,6893,8988,Ivan Duque,6816,6110,501,205,27,50,77
Copacabana,Antioquia,66571,36573,29998,Ivan Duque,35749,23846,9435,2468,58,766,824
Dabeiba,Antioquia,17541,6621,10920,Ivan Duque,6458,4581,1672,205,39,124,163
Don Matías,Antioquia,17033,9098,7935,Ivan Duque,8983,7705,898,380,16,99,115
Ebéjico,Antioquia,11258,5340,5918,Ivan Duque,5251,4599,478,174,20,69,89
El Bagre,Antioquia,36574,12312,24262,Ivan Duque,12082,7823,3811,448,31,199,230
Entrerríos,Antioquia,8462,4597,3865,Ivan Duque,4536,3704,540,292,12,49,61
Envigado,Antioquia,241042,145836,95206,Ivan Duque,144074,109479,25879,8716,114,1648,1762
Fredonia,Antioquia,18205,7943,10262,Ivan Duque,7767,6000,1375,392,29,147,176
Frontino,Antioquia,16854,6139,10715,Ivan Duque,5959,4280,1410,269,40,140,180
Giraldo,Antioquia,4342,2439,1903,Ivan Duque,2396,1752,533,111,7,36,43
Girardota,Antioquia,49817,25652,24165,Ivan Duque,24860,16322,6628,1910,60,732,792
Gómez Plata,Antioquia,8435,4203,4232,Ivan Duque,4115,3590,383,142,19,69,88
Granada,Antioquia,10039,5338,4701,Ivan Duque,5286,4713,414,159,17,35,52
Guadalupe,Antioquia,5752,2083,3669,Ivan Duque,2020,1546,364,110,25,38,63
Guarne,Antioquia,34883,23247,11636,Ivan Duque,22824,17570,3924,1330,55,368,423
Guatapé,Antioquia,6871,4583,2288,Ivan Duque,4530,3616,727,187,6,47,53
Heliconia,Antioquia,6032,2750,3282,Ivan Duque,2693,2305,291,97,9,48,57
Hispania,Antioquia,5366,2449,2917,Ivan Duque,2426,1976,360,90,6,17,23
Itagüí,Antioquia,253471,139099,114372,Ivan Duque,136425,98075,29397,8953,140,2534,2674
Ituango,Antioquia,17607,4386,13221,Ivan Duque,4184,2599,1234,351,71,131,202
Jardín,Antioquia,12392,7478,4914,Ivan Duque,7405,5645,1462,298,15,58,73
Jericó,Antioquia,11033,6187,4846,Ivan Duque,6106,5280,627,199,16,65,81
La Ceja,Antioquia,47648,32601,15047,Ivan Duque,31906,24642,5323,1941,73,622,695
La Estrella,Antioquia,58076,31949,26127,Ivan Duque,31242,21974,7086,2182,38,669,707
La Pintada,Antioquia,6961,3587,3374,Ivan Duque,3527,2857,562,108,13,47,60
La Unión,Antioquia,17164,11396,5768,Ivan Duque,11218,9029,1693,496,24,154,178
Liborina,Antioquia,9118,4754,4364,Ivan Duque,4691,4053,483,155,13,50,63
Maceo,Antioquia,7719,3658,4061,Ivan Duque,3611,2987,492,132,10,37,47
Marinilla,Antioquia,41281,27023,14258,Ivan Duque,26639,20433,5013,1193,44,340,384
Montebello,Antioquia,6185,3017,3168,Ivan Duque,2942,2465,342,135,22,53,75
Murindó,Antioquia,3010,1299,1711,Gustavo Petro,1284,148,1126,10,8,7,15
Mutatá,Antioquia,10699,4227,6472,Ivan Duque,4143,2414,1636,93,15,69,84
Nariño,Antioquia,8821,4114,4707,Ivan Duque,4085,3850,166,69,14,15,29
Necoclí,Antioquia,33425,12865,20560,Ivan Duque,12651,8124,4258,269,65,149,214
Nechí,Antioquia,18198,5118,13080,Ivan Duque,5068,3671,1311,86,7,43,50
Olaya,Antioquia,2914,1611,1303,Ivan Duque,1591,1368,175,48,6,14,20
Peñol,Antioquia,16308,9527,6781,Ivan Duque,9418,7959,1143,316,13,96,109
Peque,Antioquia,6063,3003,3060,Ivan Duque,2931,2370,448,113,21,51,72
Pueblorrico,Antioquia,7106,3522,3584,Ivan Duque,3485,3064,345,76,10,27,37
Puerto Berrío,Antioquia,34079,14206,19873,Ivan Duque,13876,9727,3501,648,53,277,330
Puerto Nare,Antioquia,11937,5529,6408,Ivan Duque,5423,3387,1933,103,13,93,106
Puerto Triunfo,Antioquia,13768,7321,6447,Ivan Duque,7211,5970,1040,201,21,89,110
Remedios,Antioquia,18027,5532,12495,Ivan Duque,5348,2922,1972,454,32,152,184
Retiro,Antioquia,17049,12012,5037,Ivan Duque,11857,9827,1468,562,24,131,155
Rionegro,Antioquia,103860,70046,33814,Ivan Duque,68742,51654,13161,3927,88,1216,1304
Sabanalarga,Antioquia,7134,3453,3681,Ivan Duque,3401,2991,295,115,15,37,52
Sabaneta,Antioquia,70193,45563,24630,Ivan Duque,45037,33270,9057,2710,36,490,526
Salgar,Antioquia,13482,6336,7146,Ivan Duque,6281,5807,347,127,15,40,55
San Andrés de Cuerquía,Antioquia,5255,2136,3119,Ivan Duque,2053,1704,257,92,27,56,83
San Carlos,Antioquia,14045,7287,6758,Ivan Duque,7171,5991,942,238,24,92,116
San Francisco,Antioquia,6182,2799,3383,Ivan Duque,2762,2385,328,49,11,26,37
San Jerónimo,Antioquia,12393,6450,5943,Ivan Duque,6361,5512,609,240,11,78,89
San José de La Montaña,Antioquia,3122,1550,1572,Ivan Duque,1512,1280,153,79,15,23,38
San Juan de Urabá,Antioquia,17747,7378,10369,Ivan Duque,7305,4342,2849,114,25,48,73
San Luis,Antioquia,11011,6098,4913,Ivan Duque,6046,5232,647,167,18,34,52
San Pedro,Antioquia,20146,11846,8300,Ivan Duque,11673,9877,1229,567,20,153,173
San Pedro de Urabá,Antioquia,25750,10676,15074,Ivan Duque,10579,8110,2241,228,21,76,97
San Rafael,Antioquia,12273,6238,6035,Ivan Duque,6124,5056,834,234,21,93,114
San Roque,Antioquia,14772,7133,7639,Ivan Duque,6981,6070,693,218,48,104,152
San Vicente,Antioquia,16236,10164,6072,Ivan Duque,10014,8551,1166,297,27,123,150
Santa Bárbara,Antioquia,22126,10662,11464,Ivan Duque,10418,8160,1743,515,28,216,244
Santa Rosa de Osos,Antioquia,26407,15458,10949,Ivan Duque,15069,12619,1694,756,66,323,389
Santo Domingo,Antioquia,9172,4696,4476,Ivan Duque,4581,3890,532,159,35,80,115
El Santuario,Antioquia,27101,18180,8921,Ivan Duque,18018,15702,1790,526,41,121,162
Segovia,Antioquia,27130,7602,19528,Gustavo Petro,7335,2715,3969,651,24,243,267
Sonsón,Antioquia,26908,15159,11749,Ivan Duque,14968,13493,1063,412,31,160,191
Sopetrán,Antioquia,12280,6069,6211,Ivan Duque,5947,4611,1055,281,13,109,122
Támesis,Antioquia,14424,7716,6708,Ivan Duque,7586,6061,1190,335,23,107,130
Tarazá,Antioquia,25880,5480,20400,Ivan Duque,5302,2698,2351,253,28,150,178
Tarso,Antioquia,5894,2510,3384,Ivan Duque,2478,1887,527,64,11,21,32
Titiribí,Antioquia,8672,3650,5022,Ivan Duque,3561,2941,448,172,13,76,89
Toledo,Antioquia,4502,1790,2712,Ivan Duque,1699,1288,276,135,27,64,91
Turbo,Antioquia,85106,36548,48558,Ivan Duque,35958,17842,17102,1014,82,508,590
Uramita,Antioquia,6353,2784,3569,Ivan Duque,2712,2380,254,78,20,52,72
Urrao,Antioquia,22724,8813,13911,Ivan Duque,8652,7131,1147,374,50,111,161
Valdivia,Antioquia,11987,3043,8944,Ivan Duque,2940,2054,757,129,35,68,103
Valparaíso,Antioquia,5656,2775,2881,Ivan Duque,2704,2049,522,133,13,58,71
Vegachí,Antioquia,10324,4111,6213,Ivan Duque,4036,3572,345,119,20,55,75
Venecia,Antioquia,11084,5107,5977,Ivan Duque,5042,4221,652,169,9,56,65
Vigía del Fuerte,Antioquia,6068,2076,3992,Gustavo Petro,2045,708,1266,71,13,18,31
Yalí,Antioquia,6094,2627,3467,Ivan Duque,2585,2146,357,82,10,32,42
Yarumal,Antioquia,33089,14701,18388,Ivan Duque,14360,11635,2001,724,63,278,341
Yolombó,Antioquia,15720,6428,9292,Ivan Duque,6305,5184,893,228,35,88,123
Yondó,Antioquia,12961,7117,5844,Ivan Duque,6896,3620,3016,260,13,208,221
Zaragoza,Antioquia,19182,5682,13500,Ivan Duque,5535,3407,1934,194,28,119,147
Barranquilla,Atlántico,1066702,448947,617755,Gustavo Petro,446273,192265,242474,11534,259,2415,2674
Baranoa,Atlántico,47096,23687,23409,Gustavo Petro,23510,8515,14573,422,25,152,177
Campo de La Cruz,Atlántico,20612,8198,12414,Ivan Duque,8147,5769,2275,103,7,44,51
Candelaria,Atlántico,12514,5234,7280,Ivan Duque,5200,3789,1354,57,11,23,34
Galapa,Atlántico,38793,15937,22856,Gustavo Petro,15804,5695,9787,322,12,121,133
Juan de Acosta,Atlántico,18541,8253,10288,Ivan Duque,8198,5074,3018,106,9,46,55
Luruaco,Atlántico,24168,9361,14807,Ivan Duque,9266,5668,3450,148,24,71,95
Malambo,Atlántico,81189,32749,48440,Gustavo Petro,32501,11660,20302,539,53,195,248
Manatí,Atlántico,14291,5492,8799,Ivan Duque,5451,3941,1417,93,6,35,41
Palmar de Varela,Atlántico,20785,9444,11341,Gustavo Petro,9368,3116,6083,169,13,63,76
Piojó,Atlántico,5548,2430,3118,Ivan Duque,2409,1337,1047,25,5,16,21
Polonuevo,Atlántico,13033,7110,5923,Gustavo Petro,7029,2230,4689,110,17,64,81
Ponedera,Atlántico,18526,7779,10747,Ivan Duque,7711,4474,3146,91,10,58,68
Puerto Colombia,Atlántico,34795,16203,18592,Gustavo Petro,16103,6838,8920,345,5,95,100
Repelón,Atlántico,19147,9150,9997,Ivan Duque,9064,5643,3287,134,23,63,86
Sabanagrande,Atlántico,23704,11824,11880,Gustavo Petro,11725,4725,6775,225,10,89,99
Sabanalarga,Atlántico,67099,34111,32988,Gustavo Petro,33764,14580,18560,624,36,311,347
Santa Lucía,Atlántico,11057,5400,5657,Ivan Duque,5375,3888,1448,39,4,21,25
Santo Tomás,Atlántico,26967,12437,14530,Gustavo Petro,12363,4387,7709,267,14,60,74
Soledad,Atlántico,275722,119908,155814,Gustavo Petro,119064,42620,74273,2171,54,790,844
Suan,Atlántico,10218,4571,5647,Ivan Duque,4555,3108,1373,74,1,15,16
Tubará,Atlántico,9943,5334,4609,Gustavo Petro,5289,2188,3029,72,9,36,45
Usiacurí,Atlántico,7961,4237,3724,Ivan Duque,4181,2119,1986,76,5,51,56
Bogotá D.C.,Bogotá D.C.,5702805,3578130,2124675,Gustavo Petro,3538391,1449092,1889050,200249,1417,38322,39739
Cartagena,Bolívar,750215,316945,433270,Gustavo Petro,315341,130583,177075,7683,206,1398,1604
Achí,Bolívar,16609,8381,8228,Ivan Duque,8345,7101,1195,49,11,25,36
Altos del Rosario,Bolívar,6897,2622,4275,Ivan Duque,2598,1794,776,28,5,19,24
Arenal,Bolívar,5789,2529,3260,Ivan Duque,2511,1469,1014,28,0,18,18
Arjona,Bolívar,53278,23481,29797,Gustavo Petro,23241,10665,12111,465,25,215,240
Arroyohondo,Bolívar,8758,3397,5361,Ivan Duque,3367,2769,575,23,6,24,30
Barranco de Loba,Bolívar,11248,4820,6428,Ivan Duque,4779,3668,1070,41,12,29,41
Calamar,Bolívar,17743,7605,10138,Ivan Duque,7501,5098,2305,98,20,84,104
Cantagallo,Bolívar,6526,3323,3203,Gustavo Petro,3279,1518,1698,63,3,41,44
Cicuco,Bolívar,9984,4425,5559,Ivan Duque,4390,2427,1929,34,10,25,35
Córdoba,Bolívar,13663,7042,6621,Gustavo Petro,6999,3446,3487,66,18,25,43
Clemencia,Bolívar,11076,4594,6482,Ivan Duque,4531,2817,1638,76,12,51,63
El Carmen de Bolívar,Bolívar,54965,25914,29051,Ivan Duque,25682,19296,6074,312,35,197,232
El Guamo,Bolívar,8025,3410,4615,Ivan Duque,3377,2251,1095,31,11,22,33
El Peñón,Bolívar,6344,2674,3670,Ivan Duque,2663,1792,853,18,3,8,11
Hatillo de Loba,Bolívar,10432,4362,6070,Ivan Duque,4331,3530,772,29,8,23,31
Magangué,Bolívar,93880,43465,50415,Ivan Duque,43081,22192,20322,567,69,315,384
Mahates,Bolívar,20121,8709,11412,Ivan Duque,8647,5731,2829,87,10,52,62
Margarita,Bolívar,9549,4097,5452,Ivan Duque,4080,3092,963,25,8,9,17
María La Baja,Bolívar,39270,15664,23606,Gustavo Petro,15518,7065,8291,162,23,123,146
Montecristo,Bolívar,8363,2829,5534,Ivan Duque,2813,1917,854,42,3,13,16
Mompós,Bolívar,35554,15090,20464,Ivan Duque,14998,8471,6379,148,18,74,92
Morales,Bolívar,11170,6241,4929,Ivan Duque,6174,4619,1462,93,15,52,67
Norosí,Bolívar,3982,1557,2425,Ivan Duque,1536,790,718,28,0,21,21
Pinillos,Bolívar,16573,7466,9107,Ivan Duque,7412,5520,1855,37,9,45,54
Regidor,Bolívar,4806,2226,2580,Ivan Duque,2207,1215,981,11,4,15,19
Río Viejo,Bolívar,6263,3207,3056,Ivan Duque,3182,2142,997,43,8,17,25
San Cristóbal,Bolívar,6877,3192,3685,Gustavo Petro,3180,1374,1768,38,3,9,12
San Estanislao,Bolívar,14531,7083,7448,Ivan Duque,7031,4802,2152,77,14,38,52
San Fernando,Bolívar,8446,3496,4950,Ivan Duque,3472,2307,1144,21,11,13,24
San Jacinto,Bolívar,20728,10389,10339,Ivan Duque,10303,6770,3436,97,15,71,86
San Jacinto del Cauca,Bolívar,7027,2739,4288,Ivan Duque,2708,1955,727,26,3,28,31
San Juan Nepomuceno,Bolívar,30730,14795,15935,Ivan Duque,14670,10097,4361,212,18,107,125
San Martín de Loba,Bolívar,11134,5017,6117,Ivan Duque,4991,3070,1869,52,9,17,26
San Pablo,Bolívar,18154,8647,9507,Ivan Duque,8520,5036,3326,158,32,95,127
Santa Catalina,Bolívar,11983,4737,7246,Gustavo Petro,4706,2223,2427,56,9,22,31
Santa Rosa,Bolívar,14260,6070,8190,Gustavo Petro,6013,2741,3184,88,4,53,57
Santa Rosa del Sur,Bolívar,20582,11502,9080,Ivan Duque,11350,9174,1825,351,27,125,152
Simití,Bolívar,11932,5659,6273,Ivan Duque,5594,3910,1560,124,15,50,65
Soplaviento,Bolívar,8297,3926,4371,Gustavo Petro,3916,1121,2741,54,4,6,10
Talaigua Nuevo,Bolívar,9122,4737,4385,Ivan Duque,4695,3103,1545,47,3,39,42
Tiquisio,Bolívar,13193,5098,8095,Ivan Duque,5058,4002,1010,46,10,30,40
Turbaco,Bolívar,63358,27664,35694,Gustavo Petro,27455,11559,15272,624,25,184,209
Turbaná,Bolívar,14587,7133,7454,Gustavo Petro,7103,3185,3800,118,5,25,30
Villanueva,Bolívar,15574,7240,8334,Ivan Duque,7163,4998,2057,108,15,62,77
Zambrano,Bolívar,9046,4441,4605,Gustavo Petro,4401,1190,3162,49,10,30,40
Tunja,Boyacá,121599,81531,40068,Gustavo Petro,80096,28703,47404,3989,48,1387,1435
Almeida,Boyacá,1965,927,1038,Ivan Duque,921,718,184,19,1,5,6
Aquitania,Boyacá,12478,7717,4761,Ivan Duque,7636,6296,1212,128,9,72,81
Arcabuco,Boyacá,4806,2784,2022,Ivan Duque,2718,1530,1101,87,11,55,66
Belén,Boyacá,6638,3895,2743,Ivan Duque,3808,2007,1670,131,8,79,87
Berbeo,Boyacá,1442,807,635,Ivan Duque,794,394,365,35,1,12,13
Betéitiva,Boyacá,1908,980,928,Ivan Duque,956,479,435,42,2,22,24
Boavita,Boyacá,4953,2592,2361,Ivan Duque,2561,1984,501,76,7,24,31
Boyacá,Boyacá,4280,2184,2096,Ivan Duque,2151,1319,782,50,4,29,33
Briceño,Boyacá,2193,1264,929,Ivan Duque,1248,1037,188,23,4,12,16
Buenavista,Boyacá,4607,2701,1906,Ivan Duque,2675,2081,568,26,2,24,26
Busbanzá,Boyacá,854,540,314,Ivan Duque,525,309,196,20,2,13,15
Caldas,Boyacá,3174,1723,1451,Ivan Duque,1707,1136,513,58,0,16,16
Campohermoso,Boyacá,2502,1262,1240,Ivan Duque,1251,980,232,39,0,11,11
Cerinza,Boyacá,3488,2224,1264,Ivan Duque,2176,1113,993,70,3,45,48
Chinavita,Boyacá,2990,1611,1379,Ivan Duque,1595,1227,320,48,4,12,16
Chiquinquirá,Boyacá,40741,24206,16535,Ivan Duque,23832,13505,9321,1006,13,361,374
Chiscas,Boyacá,3321,1784,1537,Ivan Duque,1771,1535,222,14,2,11,13
Chita,Boyacá,6087,3218,2869,Ivan Duque,3185,2678,448,59,9,24,33
Chitaraque,Boyacá,5411,2838,2573,Ivan Duque,2808,2368,398,42,6,24,30
Chivatá,Boyacá,2674,1606,1068,Ivan Duque,1579,770,758,51,2,25,27
Ciénega,Boyacá,3790,2288,1502,Ivan Duque,2266,1754,442,70,5,17,22
Cómbita,Boyacá,8929,5024,3905,Gustavo Petro,4922,2124,2604,194,9,93,102
Coper,Boyacá,3174,1718,1456,Ivan Duque,1701,1410,239,52,3,14,17
Corrales,Boyacá,2201,1374,827,Gustavo Petro,1347,618,674,55,4,23,27
Covarachía,Boyacá,3072,1563,1509,Ivan Duque,1553,1392,138,23,2,8,10
Cubará,Boyacá,5629,2476,3153,Gustavo Petro,2409,924,1396,89,12,55,67
Cucaita,Boyacá,3213,2021,1192,Gustavo Petro,1987,804,1131,52,2,32,34
Cuítiva,Boyacá,1861,1032,829,Ivan Duque,1025,657,342,26,1,6,7
Chíquiza,Boyacá,4466,2223,2243,Gustavo Petro,2157,651,1454,52,8,58,66
Chivor,Boyacá,1806,1019,787,Ivan Duque,1006,893,98,15,4,9,13
Duitama,Boyacá,86458,57765,28693,Gustavo Petro,56770,23538,30581,2651,32,963,995
El Cocuy,Boyacá,3496,2066,1430,Ivan Duque,2050,1770,230,50,2,14,16
El Espino,Boyacá,2254,1351,903,Ivan Duque,1344,1195,131,18,3,4,7
Firavitoba,Boyacá,5777,3034,2743,Gustavo Petro,2984,1406,1454,124,6,44,50
Floresta,Boyacá,3088,1930,1158,Ivan Duque,1910,1263,598,49,6,14,20
Gachantivá,Boyacá,2994,1840,1154,Ivan Duque,1793,1212,547,34,2,45,47
Gámeza,Boyacá,3982,2276,1706,Ivan Duque,2240,1640,546,54,12,24,36
Garagoa,Boyacá,11756,6984,4772,Ivan Duque,6883,3923,2693,267,6,95,101
Guacamayas,Boyacá,1611,960,651,Ivan Duque,955,834,108,13,2,3,5
Guateque,Boyacá,8849,4928,3921,Ivan Duque,4830,2835,1818,177,9,89,98
Guayatá,Boyacá,3760,2170,1590,Ivan Duque,2151,1786,324,41,7,12,19
Güicán,Boyacá,2951,1758,1193,Ivan Duque,1737,1176,531,30,4,17,21
Iza,Boyacá,2181,1282,899,Ivan Duque,1267,808,427,32,2,13,15
Jenesano,Boyacá,5640,3117,2523,Ivan Duque,3071,1925,1076,70,10,36,46
Jericó,Boyacá,3183,1778,1405,Ivan Duque,1748,1511,223,14,9,21,30
Labranzagrande,Boyacá,2823,1738,1085,Ivan Duque,1718,1391,298,29,3,17,20
La Capilla,Boyacá,2475,1505,970,Ivan Duque,1492,1042,417,33,2,11,13
La Victoria,Boyacá,1678,865,813,Ivan Duque,855,724,116,15,2,8,10
La Uvita,Boyacá,2472,1423,1049,Ivan Duque,1415,1230,143,42,3,5,8
Villa de Leyva,Boyacá,11132,7618,3514,Ivan Duque,7533,4204,2925,404,12,73,85
Macanal,Boyacá,3547,1957,1590,Ivan Duque,1930,1501,393,36,4,23,27
Maripí,Boyacá,6145,2846,3299,Ivan Duque,2805,2293,480,32,13,28,41
Miraflores,Boyacá,7445,4576,2869,Gustavo Petro,4503,2065,2270,168,7,66,73
Mongua,Boyacá,3996,2697,1299,Ivan Duque,2674,2257,375,42,4,19,23
Monguí,Boyacá,3741,2292,1449,Ivan Duque,2265,1433,776,56,3,24,27
Moniquirá,Boyacá,17657,10223,7434,Ivan Duque,9967,5889,3730,348,25,231,256
Motavita,Boyacá,5215,3178,2037,Gustavo Petro,3112,1075,1961,76,12,54,66
Muzo,Boyacá,7425,4265,3160,Ivan Duque,4198,3315,762,121,6,61,67
Nobsa,Boyacá,12127,8542,3585,Gustavo Petro,8464,2352,5830,282,4,74,78
Nuevo Colón,Boyacá,4571,2619,1952,Ivan Duque,2558,1350,1123,85,10,51,61
Oicatá,Boyacá,2625,1666,959,Ivan Duque,1641,820,772,49,0,25,25
Otanche,Boyacá,6378,3483,2895,Ivan Duque,3442,3010,365,67,7,34,41
Pachavita,Boyacá,1952,1111,841,Ivan Duque,1098,833,236,29,2,11,13
Páez,Boyacá,2395,1490,905,Ivan Duque,1483,1115,324,44,0,7,7
Paipa,Boyacá,25890,16686,9204,Gustavo Petro,16409,7356,8348,705,16,261,277
Pajarito,Boyacá,1667,966,701,Ivan Duque,958,766,167,25,3,5,8
Panqueba,Boyacá,1616,895,721,Ivan Duque,886,768,107,11,2,7,9
Pauna,Boyacá,6599,3580,3019,Ivan Duque,3540,2614,869,57,7,33,40
Paya,Boyacá,1555,977,578,Ivan Duque,962,737,200,25,5,10,15
Paz de Río,Boyacá,4236,2396,1840,Gustavo Petro,2355,748,1535,72,7,34,41
Pesca,Boyacá,6370,3293,3077,Ivan Duque,3261,2297,864,100,5,27,32
Pisba,Boyacá,1028,616,412,Ivan Duque,607,444,158,5,5,4,9
Puerto Boyacá,Boyacá,36098,20527,15571,Ivan Duque,19730,13546,5327,857,63,734,797
Quípama,Boyacá,5067,2817,2250,Ivan Duque,2780,2325,401,54,8,29,37
Ramiriquí,Boyacá,8598,4815,3783,Ivan Duque,4736,2890,1710,136,9,70,79
Ráquira,Boyacá,4615,2867,1748,Ivan Duque,2834,1822,880,132,8,25,33
Rondón,Boyacá,2269,1336,933,Ivan Duque,1319,972,319,28,6,11,17
Saboyá,Boyacá,9545,5896,3649,Ivan Duque,5768,3639,2010,119,20,108,128
Sáchica,Boyacá,3499,2313,1186,Ivan Duque,2273,1199,1003,71,3,37,40
Samacá,Boyacá,13885,7958,5927,Ivan Duque,7784,4223,3281,280,10,164,174
San Eduardo,Boyacá,1473,898,575,Ivan Duque,886,516,323,47,3,9,12
San José de Pare,Boyacá,5381,2731,2650,Ivan Duque,2698,2127,506,65,5,28,33
San Luis de Gaceno,Boyacá,4381,2509,1872,Ivan Duque,2487,2094,328,65,7,15,22
San Mateo,Boyacá,3562,2054,1508,Ivan Duque,2045,1845,175,25,2,7,9
San Miguel de Sema,Boyacá,2691,1514,1177,Ivan Duque,1492,1080,347,65,5,17,22
San Pablo de Borbur,Boyacá,5776,3256,2520,Ivan Duque,3213,2735,412,66,6,37,43
Santana,Boyacá,6939,3643,3296,Ivan Duque,3599,2291,1206,102,2,42,44
Santa María,Boyacá,3186,1588,1598,Ivan Duque,1548,936,544,68,8,32,40
Santa Rosa de Viterbo,Boyacá,8147,5334,2813,Ivan Duque,5245,3101,1936,208,7,82,89
Santa Sofía,Boyacá,3042,1805,1237,Ivan Duque,1773,1393,335,45,6,26,32
Sativanorte,Boyacá,2451,1381,1070,Ivan Duque,1368,1172,174,22,5,8,13
Sativasur,Boyacá,1213,616,597,Ivan Duque,605,383,204,18,0,11,11
Siachoque,Boyacá,6191,3819,2372,Ivan Duque,3750,2363,1291,96,15,54,69
Soatá,Boyacá,7413,4638,2775,Ivan Duque,4593,3279,1188,126,12,33,45
Socotá,Boyacá,5774,3145,2629,Ivan Duque,3102,2324,715,63,7,36,43
Socha,Boyacá,6041,3210,2831,Ivan Duque,3124,1775,1241,108,10,76,86
Sogamoso,Boyacá,91941,59905,32036,Gustavo Petro,58885,25822,30407,2656,55,965,1020
Somondoco,Boyacá,2670,1448,1222,Ivan Duque,1425,985,411,29,2,21,23
Sora,Boyacá,2611,1637,974,Gustavo Petro,1593,748,800,45,5,39,44
Sotaquirá,Boyacá,5494,3516,1978,Ivan Duque,3470,2101,1279,90,7,39,46
Soracá,Boyacá,5486,3661,1825,Ivan Duque,3623,2465,1100,58,4,34,38
Susacón,Boyacá,2651,1571,1080,Ivan Duque,1555,1295,223,37,7,9,16
Sutamarchán,Boyacá,5497,3521,1976,Ivan Duque,3480,2344,1027,109,6,35,41
Sutatenza,Boyacá,3666,2088,1578,Ivan Duque,2057,1471,535,51,3,28,31
Tasco,Boyacá,4816,2383,2433,Ivan Duque,2327,1166,1100,61,10,46,56
Tenza,Boyacá,3444,1883,1561,Ivan Duque,1852,1365,420,67,5,26,31
Tibaná,Boyacá,7337,3600,3737,Ivan Duque,3530,2041,1401,88,15,55,70
Tibasosa,Boyacá,8726,5425,3301,Gustavo Petro,5334,2360,2737,237,5,86,91
Tinjacá,Boyacá,2778,1782,996,Ivan Duque,1766,1021,686,59,3,13,16
Tipacoque,Boyacá,3335,1767,1568,Ivan Duque,1741,1303,399,39,9,17,26
Toca,Boyacá,7082,4178,2904,Gustavo Petro,4106,1948,2010,148,6,66,72
Togüí,Boyacá,4317,2248,2069,Ivan Duque,2193,1643,495,55,10,45,55
Tópaga,Boyacá,3025,2002,1023,Ivan Duque,1965,1226,674,65,4,33,37
Tota,Boyacá,4090,2042,2048,Ivan Duque,2006,1576,386,44,10,26,36
Tununguá,Boyacá,1364,804,560,Ivan Duque,797,545,235,17,2,5,7
Turmequé,Boyacá,5611,2931,2680,Ivan Duque,2866,1471,1275,120,8,57,65
Tuta,Boyacá,7544,4697,2847,Ivan Duque,4605,2392,2049,164,11,81,92
Tutazá,Boyacá,1811,1081,730,Ivan Duque,1057,579,449,29,3,21,24
Úmbita,Boyacá,5648,3424,2224,Ivan Duque,3397,2490,834,73,1,26,27
Ventaquemada,Boyacá,10928,6067,4861,Ivan Duque,5943,2971,2786,186,8,116,124
Viracachá,Boyacá,2497,1540,957,Ivan Duque,1517,1151,339,27,0,23,23
Zetaquira,Boyacá,3932,2281,1651,Ivan Duque,2273,1523,711,39,1,7,8
Manizales,Caldas,325422,197022,128400,Ivan Duque,191198,104173,71022,16003,373,5451,5824
Aguadas,Caldas,18555,10513,8042,Ivan Duque,10290,8897,1048,345,35,188,223
Anserma,Caldas,27803,15742,12061,Ivan Duque,15320,12005,2687,628,50,372,422
Aranzazu,Caldas,11177,5973,5204,Ivan Duque,5862,5136,534,192,15,96,111
Belalcázar,Caldas,10163,5410,4753,Ivan Duque,5305,4095,1043,167,16,89,105
Chinchiná,Caldas,44739,24452,20287,Ivan Duque,23642,16046,6017,1579,95,715,810
Filadelfia,Caldas,9301,4929,4372,Ivan Duque,4855,4077,618,160,11,63,74
La Dorada,Caldas,56458,28551,27907,Ivan Duque,27607,19308,7189,1110,50,894,944
La Merced,Caldas,5552,2804,2748,Ivan Duque,2745,2178,431,136,13,46,59
Manzanares,Caldas,15318,8200,7118,Ivan Duque,8076,6888,983,205,21,103,124
Marmato,Caldas,6889,3023,3866,Ivan Duque,2893,2131,634,128,10,120,130
Marquetalia,Caldas,11415,6184,5231,Ivan Duque,6083,5089,835,159,21,80,101
Marulanda,Caldas,2535,1229,1306,Ivan Duque,1197,993,153,51,8,24,32
Neira,Caldas,19574,10987,8587,Ivan Duque,10620,8036,2052,532,64,303,367
Norcasia,Caldas,5866,2783,3083,Ivan Duque,2680,1949,584,147,13,90,103
Pácora,Caldas,11865,6845,5020,Ivan Duque,6696,5859,577,260,28,121,149
Palestina,Caldas,14945,7048,7897,Ivan Duque,6848,4860,1714,274,13,187,200
Pensilvania,Caldas,16240,9157,7083,Ivan Duque,8986,7707,1029,250,41,130,171
Riosucio,Caldas,38548,22553,15995,Ivan Duque,22002,14635,6517,850,81,470,551
Risaralda,Caldas,10526,5338,5188,Ivan Duque,5221,4277,773,171,19,98,117
Salamina,Caldas,15158,7609,7549,Ivan Duque,7430,5606,1426,398,34,145,179
Samaná,Caldas,15937,9089,6848,Ivan Duque,8913,7628,1067,218,44,132,176
San José,Caldas,4976,2692,2284,Ivan Duque,2648,2076,486,86,11,33,44
Supía,Caldas,21861,11946,9915,Ivan Duque,11294,8555,2220,519,69,583,652
Victoria,Caldas,8295,4321,3974,Ivan Duque,4189,3344,668,177,15,117,132
Villamaría,Caldas,40633,24869,15764,Ivan Duque,24070,14229,8033,1808,42,757,799
Viterbo,Caldas,13111,7497,5614,Ivan Duque,7379,6069,1065,245,18,100,118
Florencia,Caquetá,119908,64629,55279,Ivan Duque,63788,40730,20584,2474,73,768,841
Albania,Caquetá,3964,1973,1991,Ivan Duque,1946,1519,370,57,4,23,27
Belén de Los Andaquíes,Caquetá,7662,3833,3829,Ivan Duque,3763,2689,968,106,9,61,70
Cartagena del Chairá,Caquetá,19085,6362,12723,Gustavo Petro,6230,2730,3229,271,26,106,132
Curillo,Caquetá,7431,2673,4758,Ivan Duque,2625,1835,692,98,13,35,48
El Doncello,Caquetá,15504,6903,8601,Ivan Duque,6768,4516,1983,269,25,110,135
El Paujil,Caquetá,11767,4638,7129,Ivan Duque,4568,2552,1863,153,17,53,70
La Montañita,Caquetá,11010,4107,6903,Gustavo Petro,4052,1730,2223,99,8,47,55
Milán,Caquetá,6462,2036,4426,Ivan Duque,2016,1306,669,41,5,15,20
Morelia,Caquetá,3696,1709,1987,Ivan Duque,1696,1293,364,39,0,13,13
Puerto Rico,Caquetá,18932,7619,11313,Ivan Duque,7467,4775,2314,378,27,125,152
San José del Fragua,Caquetá,9089,4328,4761,Ivan Duque,4244,2666,1438,140,11,73,84
San Vicente del Caguán,Caquetá,32825,12894,19931,Ivan Duque,12720,7758,4433,529,31,143,174
Solano,Caquetá,7726,2136,5590,Gustavo Petro,2094,894,1135,65,14,28,42
Solita,Caquetá,5584,1930,3654,Ivan Duque,1871,1343,431,97,5,54,59
Valparaíso,Caquetá,5941,2163,3778,Ivan Duque,2123,1467,560,96,6,34,40
Popayán,Cauca,237019,138157,98862,Gustavo Petro,135882,49298,81160,5424,143,2132,2275
Almaguer,Cauca,12434,6060,6374,Gustavo Petro,5971,865,5070,36,36,53,89
Argelia,Cauca,17806,9678,8128,Gustavo Petro,9544,756,8658,130,10,124,134
Balboa,Cauca,15752,6837,8915,Gustavo Petro,6754,894,5766,94,16,67,83
Bolívar,Cauca,30646,13997,16649,Gustavo Petro,13790,3051,10598,141,34,173,207
Buenos Aires,Cauca,16018,7788,8230,Gustavo Petro,7463,3578,3608,277,80,245,325
Cajibío,Cauca,23818,11045,12773,Gustavo Petro,10692,4657,5730,305,61,292,353
Caldono,Cauca,21573,12537,9036,Gustavo Petro,12363,2996,9177,190,40,134,174
Caloto,Cauca,18375,11138,7237,Gustavo Petro,10848,3149,7336,363,22,268,290
Corinto,Cauca,17951,10870,7081,Gustavo Petro,10623,3127,7164,332,32,215,247
El Tambo,Cauca,34542,15044,19498,Ivan Duque,14596,7503,6657,436,136,312,448
Florencia,Cauca,4591,2610,1981,Gustavo Petro,2561,692,1827,42,17,32,49
Guachené,Cauca,12942,8318,4624,Gustavo Petro,7971,1640,6149,182,19,328,347
Guapi,Cauca,18748,7536,11212,Gustavo Petro,7465,1286,6123,56,11,60,71
Inzá,Cauca,16775,9112,7663,Gustavo Petro,8979,2807,6049,123,35,98,133
Jambaló,Cauca,8414,5428,2986,Gustavo Petro,5326,448,4825,53,33,69,102
La Sierra,Cauca,8930,4462,4468,Gustavo Petro,4356,1941,2324,91,23,83,106
La Vega,Cauca,14936,6694,8242,Gustavo Petro,6583,2026,4461,96,33,78,111
López,Cauca,12677,4244,8433,Gustavo Petro,4200,1777,2374,49,23,21,44
Mercaderes,Cauca,13728,6390,7338,Gustavo Petro,6303,1205,5014,84,36,51,87
Miranda,Cauca,19839,12420,7419,Gustavo Petro,12093,3105,8606,382,28,299,327
Morales,Cauca,19348,9392,9956,Gustavo Petro,9212,4379,4611,222,42,138,180
Padilla,Cauca,6721,3797,2924,Gustavo Petro,3616,678,2842,96,5,176,181
Páez,Cauca,19705,10076,9629,Gustavo Petro,9860,2956,6755,149,42,174,216
Patía,Cauca,25265,10405,14860,Gustavo Petro,10213,3040,6934,239,22,170,192
Piamonte,Cauca,5259,2263,2996,Gustavo Petro,2227,884,1300,43,6,30,36
Piendamó,Cauca,27903,14629,13274,Ivan Duque,14350,7770,6031,549,45,234,279
Puerto Tejada,Cauca,32658,18253,14405,Gustavo Petro,17817,2793,14474,550,21,415,436
Puracé,Cauca,8806,4414,4392,Gustavo Petro,4341,1680,2575,86,13,60,73
Rosas,Cauca,8703,4482,4221,Ivan Duque,4369,2257,2007,105,16,97,113
San Sebastián,Cauca,6958,3273,3685,Gustavo Petro,3216,1161,2014,41,21,36,57
Santander de Quilichao,Cauca,77147,42175,34972,Gustavo Petro,41045,15383,24162,1500,89,1041,1130
Santa Rosa,Cauca,3937,1909,2028,Gustavo Petro,1890,746,1121,23,2,17,19
Silvia,Cauca,22475,13025,9450,Gustavo Petro,12813,2528,10044,241,45,167,212
Sotará,Cauca,7186,3865,3321,Gustavo Petro,3779,1560,2129,90,20,66,86
Suárez,Cauca,16327,7142,9185,Gustavo Petro,6890,3166,3492,232,41,211,252
Sucre,Cauca,5581,3009,2572,Gustavo Petro,2985,269,2683,33,6,18,24
Timbío,Cauca,25555,14284,11271,Ivan Duque,13936,7056,6462,418,37,311,348
Timbiquí,Cauca,14597,6899,7698,Gustavo Petro,6852,1127,5683,42,6,41,47
Toribío,Cauca,17605,11271,6334,Gustavo Petro,11095,1165,9803,127,40,136,176
Totoró,Cauca,11138,6045,5093,Gustavo Petro,5953,1351,4514,88,18,74,92
Villa Rica,Cauca,13648,8155,5493,Gustavo Petro,7900,1387,6328,185,16,239,255
Valledupar,Cesar,291104,151675,139429,Ivan Duque,149987,75641,70305,4041,68,1620,1688
Aguachica,Cesar,67918,39873,28045,Ivan Duque,39160,27469,10649,1042,45,668,713
Agustín Codazzi,Cesar,46690,21677,25013,Ivan Duque,21417,11874,9183,360,25,235,260
Astrea,Cesar,14414,7560,6854,Ivan Duque,7495,4422,3003,70,15,50,65
Becerril,Cesar,16138,7636,8502,Gustavo Petro,7535,2750,4660,125,12,89,101
Bosconia,Cesar,27683,13553,14130,Ivan Duque,13436,7296,5950,190,10,107,117
Chimichagua,Cesar,23862,10959,12903,Ivan Duque,10888,6815,3942,131,11,60,71
Chiriguaná,Cesar,21729,11022,10707,Ivan Duque,10915,5414,5386,115,11,96,107
Curumaní,Cesar,26201,12982,13219,Ivan Duque,12800,6458,6082,260,20,162,182
El Copey,Cesar,22748,10868,11880,Gustavo Petro,10785,4795,5852,138,9,74,83
El Paso,Cesar,21621,12128,9493,Gustavo Petro,11997,3990,7883,124,14,117,131
Gamarra,Cesar,10429,5208,5221,Ivan Duque,5159,3504,1549,106,11,38,49
González,Cesar,4005,1802,2203,Ivan Duque,1757,1254,423,80,5,40,45
La Gloria,Cesar,10906,6050,4856,Ivan Duque,5986,3908,1989,89,11,53,64
La Jagua de Ibirico,Cesar,26803,15093,11710,Gustavo Petro,14835,5104,9399,332,17,241,258
Manaure,Cesar,7556,4253,3303,Ivan Duque,4218,2384,1776,58,4,31,35
Pailitas,Cesar,14490,7570,6920,Ivan Duque,7423,4323,2920,180,17,130,147
Pelaya,Cesar,13937,7122,6815,Ivan Duque,7010,4985,1907,118,14,98,112
Pueblo Bello,Cesar,18132,7480,10652,Gustavo Petro,7385,3156,4129,100,28,67,95
Río de Oro,Cesar,15423,8412,7011,Ivan Duque,8303,6073,2040,190,18,91,109
La Paz,Cesar,19832,9705,10127,Ivan Duque,9633,6443,3032,158,12,60,72
San Alberto,Cesar,18439,9994,8445,Ivan Duque,9845,5599,3997,249,9,140,149
San Diego,Cesar,14603,7620,6983,Ivan Duque,7541,4663,2733,145,7,72,79
San Martín,Cesar,15450,9550,5900,Ivan Duque,9355,5839,3263,253,16,179,195
Tamalameque,Cesar,10229,4941,5288,Ivan Duque,4907,2656,2204,47,5,29,34
Montería,Córdoba,314508,164038,150470,Ivan Duque,162633,89531,69875,3227,167,1238,1405
Ayapel,Córdoba,32450,13978,18472,Ivan Duque,13861,8863,4837,161,16,101,117
Buenavista,Córdoba,17420,8005,9415,Gustavo Petro,7912,3542,4233,137,13,80,93
Canalete,Córdoba,16102,7184,8918,Gustavo Petro,7131,3470,3602,59,18,35,53
Cereté,Córdoba,73045,40036,33009,Gustavo Petro,39710,18214,20832,664,28,298,326
Chimá,Córdoba,13107,6737,6370,Ivan Duque,6700,3454,3205,41,8,29,37
Chinú,Córdoba,36920,21666,15254,Ivan Duque,21514,14125,7106,283,21,131,152
Ciénaga de Oro,Córdoba,43696,24196,19500,Gustavo Petro,23975,8869,14832,274,46,175,221
Cotorra,Córdoba,14621,7929,6692,Ivan Duque,7889,4073,3721,95,4,36,40
La Apartada,Córdoba,12769,5830,6939,Gustavo Petro,5737,2179,3445,113,23,70,93
Lorica,Córdoba,86010,44214,41796,Gustavo Petro,43931,21661,21788,482,32,251,283
Los Córdobas,Córdoba,14788,7349,7439,Ivan Duque,7292,4328,2877,87,14,43,57
Momil,Córdoba,13955,7726,6229,Ivan Duque,7691,4254,3355,82,10,25,35
Montelíbano,Córdoba,56437,29328,27109,Gustavo Petro,29029,8606,19913,510,35,264,299
Moñitos,Córdoba,18449,8150,10299,Ivan Duque,8074,4247,3745,82,14,62,76
Planeta Rica,Córdoba,53217,25457,27760,Gustavo Petro,25190,12043,12688,459,49,218,267
Pueblo Nuevo,Córdoba,24280,12497,11783,Ivan Duque,12397,6845,5400,152,24,76,100
Puerto Escondido,Córdoba,18257,8547,9710,Ivan Duque,8501,4483,3945,73,17,29,46
Puerto Libertador,Córdoba,26482,13110,13372,Gustavo Petro,12962,3380,9291,291,34,114,148
Purísima,Córdoba,13656,7072,6584,Ivan Duque,7021,4488,2447,86,19,32,51
Sahagún,Córdoba,79486,40705,38781,Gustavo Petro,40373,19457,20420,496,59,273,332
San Andrés Sotavento,Córdoba,28695,15075,13620,Ivan Duque,14898,7397,7393,108,27,150,177
San Antero,Córdoba,21641,11704,9937,Ivan Duque,11617,6402,5079,136,14,73,87
San Bernardo del Viento,Córdoba,26700,11745,14955,Gustavo Petro,11644,3958,7561,125,25,76,101
San Carlos,Córdoba,19990,9079,10911,Ivan Duque,8994,5185,3713,96,23,62,85
San José de Uré,Córdoba,7790,3627,4163,Gustavo Petro,3586,1042,2500,44,10,31,41
San Pelayo,Córdoba,36045,18532,17513,Gustavo Petro,18432,8983,9266,183,17,83,100
Tierralta,Córdoba,62740,26828,35912,Ivan Duque,26524,13446,12665,413,46,258,304
Tuchín,Córdoba,22221,12563,9658,Ivan Duque,12401,7033,5295,73,21,141,162
Valencia,Córdoba,25601,11978,13623,Ivan Duque,11875,7125,4567,183,20,83,103
Agua de Dios,Cundinamarca,9726,5411,4315,Ivan Duque,5292,2949,2116,227,6,113,119
Albán,Cundinamarca,5146,2912,2234,Ivan Duque,2853,2114,634,105,5,54,59
Anapoima,Cundinamarca,11918,7331,4587,Ivan Duque,7278,5550,1524,204,3,50,53
Anolaima,Cundinamarca,11449,6439,5010,Ivan Duque,6353,4640,1496,217,10,76,86
Arbeláez,Cundinamarca,9076,5731,3345,Ivan Duque,5655,4068,1360,227,9,67,76
Beltrán,Cundinamarca,2113,1092,1021,Ivan Duque,1077,826,237,14,4,11,15
Bituima,Cundinamarca,2793,1345,1448,Ivan Duque,1328,1012,281,35,8,9,17
Bojacá,Cundinamarca,6257,4371,1886,Ivan Duque,4199,2486,1495,218,3,169,172
Cabrera,Cundinamarca,3466,1896,1570,Gustavo Petro,1879,643,1209,27,3,14,17
Cachipay,Cundinamarca,9106,5268,3838,Ivan Duque,5198,3495,1498,205,5,65,70
Cajicá,Cundinamarca,46894,33256,13638,Ivan Duque,32596,16810,13650,2136,21,639,660
Caparrapí,Cundinamarca,10377,5355,5022,Ivan Duque,5295,4589,601,105,8,52,60
Cáqueza,Cundinamarca,14476,8664,5812,Ivan Duque,8525,5631,2591,303,8,131,139
Carmen de Carupa,Cundinamarca,6090,3496,2594,Ivan Duque,3449,2594,717,138,9,38,47
Chaguaní,Cundinamarca,3687,1975,1712,Ivan Duque,1959,1607,316,36,0,16,16
Chía,Cundinamarca,91865,63419,28446,Ivan Duque,62464,34471,23532,4461,32,923,955
Chipaque,Cundinamarca,7570,4908,2662,Ivan Duque,4851,3353,1363,135,6,51,57
Choachí,Cundinamarca,11475,7326,4149,Ivan Duque,7250,5451,1518,281,3,73,76
Chocontá,Cundinamarca,14834,9088,5746,Ivan Duque,8858,6063,2397,398,22,208,230
Cogua,Cundinamarca,14054,9795,4259,Ivan Duque,9561,4673,4390,498,6,228,234
Cota,Cundinamarca,25452,16019,9433,Ivan Duque,15814,9081,5801,932,9,196,205
Cucunubá,Cundinamarca,4704,3007,1697,Ivan Duque,2933,2198,588,147,10,64,74
El Colegio,Cundinamarca,20978,12306,8672,Ivan Duque,12148,8064,3758,326,9,149,158
El Peñón,Cundinamarca,4344,2334,2010,Ivan Duque,2316,2072,207,37,3,15,18
El Rosal,Cundinamarca,15842,11747,4095,Ivan Duque,11367,8003,2763,601,3,377,380
Facatativá,Cundinamarca,91630,62075,29555,Ivan Duque,59868,29830,26465,3573,40,2167,2207
Fómeque,Cundinamarca,9526,6091,3435,Ivan Duque,6030,4882,988,160,2,59,61
Fosca,Cundinamarca,5388,3172,2216,Ivan Duque,3156,2643,457,56,1,15,16
Funza,Cundinamarca,66679,45441,21238,Gustavo Petro,44212,20107,21581,2524,42,1187,1229
Fúquene,Cundinamarca,3934,2303,1631,Ivan Duque,2265,1214,955,96,1,37,38
Fusagasugá,Cundinamarca,103565,63010,40555,Ivan Duque,62015,38135,21159,2721,47,948,995
Gachalá,Cundinamarca,5148,2475,2673,Ivan Duque,2437,1794,586,57,6,32,38
Gachancipá,Cundinamarca,10090,7010,3080,Gustavo Petro,6710,3088,3205,417,8,292,300
Gachetá,Cundinamarca,9080,4968,4112,Ivan Duque,4884,3810,925,149,12,72,84
Gama,Cundinamarca,3014,1720,1294,Ivan Duque,1707,1417,239,51,2,11,13
Girardot,Cundinamarca,82360,47880,34480,Ivan Duque,46929,28868,16068,1993,38,913,951
Granada,Cundinamarca,5873,3576,2297,Ivan Duque,3517,1941,1482,94,3,56,59
Guachetá,Cundinamarca,8598,4798,3800,Ivan Duque,4635,3129,1209,297,7,156,163
Guaduas,Cundinamarca,22198,12654,9544,Ivan Duque,12387,8533,3243,611,36,231,267
Guasca,Cundinamarca,10855,7139,3716,Ivan Duque,6975,4155,2384,436,13,151,164
Guataquí,Cundinamarca,2311,1039,1272,Ivan Duque,1022,654,342,26,4,13,17
Guatavita,Cundinamarca,5088,3328,1760,Ivan Duque,3261,2291,754,216,3,64,67
Guayabal de Siquima,Cundinamarca,3855,2465,1390,Ivan Duque,2437,1806,540,91,4,24,28
Guayabetal,Cundinamarca,4526,2867,1659,Ivan Duque,2824,2227,526,71,6,37,43
Gutiérrez,Cundinamarca,2633,1783,850,Ivan Duque,1772,1514,234,24,3,8,11
Jerusalén,Cundinamarca,2594,1308,1286,Ivan Duque,1300,1009,267,24,3,5,8
Junín,Cundinamarca,5370,2881,2489,Ivan Duque,2835,2217,542,76,5,41,46
La Calera,Cundinamarca,21862,14031,7831,Ivan Duque,13811,6647,6343,821,15,205,220
La Mesa,Cundinamarca,24618,14334,10284,Ivan Duque,14165,9328,4248,589,16,153,169
La Palma,Cundinamarca,8564,3982,4582,Ivan Duque,3917,2945,874,98,13,52,65
La Peña,Cundinamarca,5791,3549,2242,Ivan Duque,3510,3181,272,57,9,30,39
La Vega,Cundinamarca,12851,8065,4786,Ivan Duque,7954,5946,1719,289,11,100,111
Lenguazaque,Cundinamarca,6916,4316,2600,Ivan Duque,4206,3375,644,187,9,101,110
Machetá,Cundinamarca,6157,3599,2558,Ivan Duque,3557,3005,449,103,5,37,42
Madrid,Cundinamarca,62604,43026,19578,Ivan Duque,41614,20283,18845,2486,34,1378,1412
Manta,Cundinamarca,4080,2511,1569,Ivan Duque,2494,2001,422,71,3,14,17
Medina,Cundinamarca,6765,3909,2856,Ivan Duque,3862,3176,561,125,4,43,47
Mosquera,Cundinamarca,68024,47848,20176,Gustavo Petro,46790,21246,22851,2693,31,1027,1058
Nariño,Cundinamarca,2638,1286,1352,Ivan Duque,1274,750,496,28,0,12,12
Nemocón,Cundinamarca,9489,6443,3046,Ivan Duque,6234,3032,2924,278,14,195,209
Nilo,Cundinamarca,6250,3264,2986,Ivan Duque,3225,2347,775,103,7,32,39
Nimaima,Cundinamarca,3156,2028,1128,Ivan Duque,2014,1709,259,46,3,11,14
Nocaima,Cundinamarca,5229,3310,1919,Ivan Duque,3273,2210,963,100,2,35,37
Venecia,Cundinamarca,3578,1826,1752,Ivan Duque,1802,1137,615,50,7,17,24
Pacho,Cundinamarca,21070,12136,8934,Ivan Duque,12002,9238,2244,520,13,121,134
Paime,Cundinamarca,4851,2314,2537,Ivan Duque,2296,1840,425,31,3,15,18
Pandi,Cundinamarca,4067,2192,1875,Ivan Duque,2158,1320,785,53,4,30,34
Paratebueno,Cundinamarca,7047,4076,2971,Ivan Duque,4014,3309,626,79,6,56,62
Pasca,Cundinamarca,7691,4434,3257,Gustavo Petro,4361,1865,2386,110,5,68,73
Puerto Salgar,Cundinamarca,12980,6308,6672,Ivan Duque,6137,4286,1637,214,9,162,171
Pulí,Cundinamarca,2867,1443,1424,Ivan Duque,1435,1169,245,21,2,6,8
Quebradanegra,Cundinamarca,4011,2733,1278,Ivan Duque,2714,2417,249,48,1,18,19
Quetame,Cundinamarca,5543,3432,2111,Ivan Duque,3385,2269,1013,103,9,38,47
Quipile,Cundinamarca,6050,3397,2653,Ivan Duque,3364,2870,429,65,9,24,33
Apulo,Cundinamarca,6906,4085,2821,Ivan Duque,4032,3158,786,88,8,45,53
Ricaurte,Cundinamarca,11090,5908,5182,Ivan Duque,5819,4161,1451,207,6,83,89
San Antonio del Tequendama,Cundinamarca,8777,5197,3580,Ivan Duque,5142,3283,1649,210,9,46,55
San Bernardo,Cundinamarca,7755,4087,3668,Ivan Duque,4040,2687,1250,103,3,44,47
San Cayetano,Cundinamarca,4398,2176,2222,Ivan Duque,2161,1798,316,47,3,12,15
San Francisco,Cundinamarca,8608,5163,3445,Ivan Duque,5111,3803,1125,183,3,49,52
San Juan de Río Seco,Cundinamarca,8967,4874,4093,Ivan Duque,4811,3491,1191,129,9,54,63
Sasaima,Cundinamarca,8824,5269,3555,Ivan Duque,5199,4055,971,173,7,63,70
Sesquilé,Cundinamarca,8073,5341,2732,Ivan Duque,5155,2720,2146,289,8,178,186
Sibaté,Cundinamarca,25447,16357,9090,Ivan Duque,15918,7656,7540,722,19,420,439
Silvania,Cundinamarca,17416,10198,7218,Ivan Duque,10074,7083,2706,285,14,110,124
Simijaca,Cundinamarca,8953,5446,3507,Ivan Duque,5349,3414,1693,242,4,93,97
Soacha,Cundinamarca,228715,148231,80484,Gustavo Petro,144997,55868,83247,5882,111,3123,3234
Sopó,Cundinamarca,17781,12999,4782,Gustavo Petro,12767,4922,7192,653,6,226,232
Subachoque,Cundinamarca,11773,8375,3398,Ivan Duque,8197,5935,1810,452,5,173,178
Suesca,Cundinamarca,10411,6772,3639,Gustavo Petro,6438,2518,3504,416,17,317,334
Supatá,Cundinamarca,4222,2477,1745,Ivan Duque,2454,2038,326,90,2,21,23
Susa,Cundinamarca,5130,3099,2031,Ivan Duque,3038,1978,961,99,6,55,61
Sutatausa,Cundinamarca,3734,2383,1351,Ivan Duque,2308,1511,671,126,7,68,75
Tabio,Cundinamarca,15946,10798,5148,Ivan Duque,10603,6402,3460,741,11,184,195
Tausa,Cundinamarca,5712,3768,1944,Ivan Duque,3668,2845,678,145,2,98,100
Tena,Cundinamarca,6550,4052,2498,Ivan Duque,4013,2670,1249,94,1,38,39
Tenjo,Cundinamarca,15388,10711,4677,Ivan Duque,10472,6549,3276,647,5,234,239
Tibacuy,Cundinamarca,3845,2184,1661,Ivan Duque,2162,1395,717,50,1,21,22
Tibirita,Cundinamarca,2919,1565,1354,Ivan Duque,1544,1137,373,34,8,13,21
Tocaima,Cundinamarca,12879,6881,5998,Ivan Duque,6783,5051,1545,187,7,91,98
Tocancipá,Cundinamarca,27294,18902,8392,Gustavo Petro,18203,6753,10383,1067,14,685,699
Topaipí,Cundinamarca,4242,2072,2170,Ivan Duque,2046,1745,264,37,11,15,26
Ubalá,Cundinamarca,8611,3946,4665,Ivan Duque,3892,3130,668,94,8,46,54
Ubaque,Cundinamarca,5766,3635,2131,Ivan Duque,3575,2509,966,100,6,54,60
Ubaté,Cundinamarca,32189,19352,12837,Ivan Duque,18815,10440,7082,1293,18,519,537
Une,Cundinamarca,6394,4072,2322,Ivan Duque,4023,2639,1212,172,1,48,49
Útica,Cundinamarca,4732,2831,1901,Ivan Duque,2806,2453,295,58,3,22,25
Vergara,Cundinamarca,7241,3942,3299,Ivan Duque,3906,3185,645,76,12,24,36
Vianí,Cundinamarca,3838,2146,1692,Ivan Duque,2117,1600,447,70,7,22,29
Villagómez,Cundinamarca,2000,1120,880,Ivan Duque,1109,900,189,20,1,10,11
Villapinzón,Cundinamarca,12992,8736,4256,Ivan Duque,8614,6710,1561,343,10,112,122
Villeta,Cundinamarca,22598,14043,8555,Ivan Duque,13891,10767,2682,442,14,138,152
Viotá,Cundinamarca,10728,6148,4580,Ivan Duque,6086,4200,1788,98,11,51,62
Yacopí,Cundinamarca,11059,5023,6036,Ivan Duque,4969,4373,507,89,12,42,54
Zipacón,Cundinamarca,4106,2595,1511,Ivan Duque,2527,1654,766,107,9,59,68
Zipaquirá,Cundinamarca,87643,59784,27859,Gustavo Petro,58475,19727,35602,3146,31,1278,1309
Quibdó,Chocó,79928,35664,44264,Gustavo Petro,34607,11725,22056,826,103,954,1057
Acandí,Chocó,8701,3365,5336,Ivan Duque,3322,2019,1230,73,11,32,43
Alto Baudó,Chocó,9928,4296,5632,Gustavo Petro,4201,320,3866,15,80,15,95
Atrato,Chocó,8789,3466,5323,Gustavo Petro,3344,1078,2221,45,16,106,122
Bagadó,Chocó,8052,2573,5479,Gustavo Petro,2530,931,1571,28,8,35,43
Bahía Solano,Chocó,7798,2790,5008,Ivan Duque,2733,1484,1178,71,11,46,57
Bajo Baudó,Chocó,10395,2789,7606,Gustavo Petro,2760,1110,1630,20,11,18,29
Bojayá,Chocó,7212,2130,5082,Gustavo Petro,2102,532,1554,16,8,20,28
El Cantón del San Pablo,Chocó,4997,1964,3033,Ivan Duque,1913,1097,784,32,5,46,51
Carmen del Darién,Chocó,6271,2305,3966,Gustavo Petro,2279,500,1760,19,3,23,26
Cértegui,Chocó,4365,1931,2434,Ivan Duque,1880,980,877,23,10,41,51
Condoto,Chocó,10454,4002,6452,Gustavo Petro,3869,1627,2161,81,15,118,133
El Carmen de Atrato,Chocó,6024,3125,2899,Ivan Duque,3072,2118,825,129,11,42,53
El Litoral del San Juan,Chocó,7405,2763,4642,Gustavo Petro,2752,166,2577,9,2,9,11
Istmina,Chocó,21369,8147,13222,Gustavo Petro,7935,3135,4574,226,41,171,212
Juradó,Chocó,3020,803,2217,Ivan Duque,796,393,389,14,0,7,7
Lloró,Chocó,8401,3077,5324,Ivan Duque,3005,1673,1283,49,18,54,72
Medio Atrato,Chocó,6048,2060,3988,Gustavo Petro,2036,649,1371,16,2,22,24
Medio Baudó,Chocó,8171,3202,4969,Ivan Duque,3179,1951,1208,20,9,14,23
Medio San Juan,Chocó,7412,2900,4512,Gustavo Petro,2832,570,2225,37,18,50,68
Nóvita,Chocó,5285,2128,3157,Ivan Duque,2064,1277,746,41,14,50,64
Nuquí,Chocó,5509,1759,3750,Gustavo Petro,1746,436,1281,29,3,10,13
Río Iro,Chocó,4151,1495,2656,Ivan Duque,1457,779,653,25,6,32,38
Río Quito,Chocó,6739,3158,3581,Gustavo Petro,3088,1397,1642,49,2,68,70
Riosucio,Chocó,19470,6404,13066,Gustavo Petro,6314,1947,4269,98,14,76,90
San José del Palmar,Chocó,4100,1213,2887,Gustavo Petro,1172,527,600,45,12,29,41
Sipí,Chocó,2580,980,1600,Gustavo Petro,958,180,771,7,4,18,22
Tadó,Chocó,12855,5719,7136,Ivan Duque,5499,3078,2329,92,31,189,220
Unguía,Chocó,8276,2988,5288,Ivan Duque,2955,1549,1325,81,8,25,33
Unión Panamericana,Chocó,5265,2238,3027,Ivan Duque,2179,1244,886,49,14,45,59
Neiva,Huila,262893,152522,110371,Ivan Duque,150290,80327,64099,5864,120,2112,2232
Acevedo,Huila,19146,11384,7762,Ivan Duque,11319,10028,1141,150,12,53,65
Agrado,Huila,6970,3913,3057,Ivan Duque,3868,2861,882,125,7,38,45
Aipe,Huila,15130,7764,7366,Ivan Duque,7661,5056,2362,243,12,91,103
Algeciras,Huila,15129,7435,7694,Ivan Duque,7307,4631,2459,217,25,103,128
Altamira,Huila,3106,1718,1388,Ivan Duque,1702,1033,618,51,1,15,16
Baraya,Huila,5967,2898,3069,Ivan Duque,2859,1952,832,75,9,30,39
Campoalegre,Huila,24833,13379,11454,Ivan Duque,13092,8252,4403,437,21,266,287
Colombia,Huila,6558,3576,2982,Ivan Duque,3536,2948,514,74,9,31,40
Elías,Huila,3297,2032,1265,Ivan Duque,2022,1585,387,50,2,8,10
Garzón,Huila,52584,29694,22890,Ivan Duque,29232,19932,8235,1065,41,421,462
Gigante,Huila,18757,10109,8648,Ivan Duque,9937,7019,2605,313,17,155,172
Guadalupe,Huila,12629,6866,5763,Ivan Duque,6770,5310,1244,216,17,79,96
Hobo,Huila,5716,2992,2724,Ivan Duque,2948,2001,888,59,7,37,44
Íquira,Huila,7016,4136,2880,Ivan Duque,4096,2660,1349,87,7,33,40
Isnos,Huila,18983,11294,7689,Ivan Duque,11122,6866,3869,387,24,148,172
La Argentina,Huila,10493,5824,4669,Ivan Duque,5767,3967,1618,182,14,43,57
La Plata,Huila,41682,22974,18708,Ivan Duque,22658,15889,6129,640,37,279,316
Nátaga,Huila,4741,2872,1869,Ivan Duque,2851,2110,687,54,4,17,21
Oporapa,Huila,7613,4693,2920,Ivan Duque,4646,3944,597,105,5,42,47
Paicol,Huila,5023,3104,1919,Ivan Duque,3071,2528,444,99,3,30,33
Palermo,Huila,20385,11097,9288,Ivan Duque,10960,7286,3364,310,16,121,137
Palestina,Huila,8869,5205,3664,Ivan Duque,5152,4067,947,138,0,53,53
Pital,Huila,9365,5439,3926,Ivan Duque,5382,4075,1154,153,7,50,57
Pitalito,Huila,94751,53011,41740,Ivan Duque,52340,33680,16860,1800,52,619,671
Rivera,Huila,16681,9188,7493,Ivan Duque,9028,5381,3311,336,8,152,160
Saladoblanco,Huila,9046,5376,3670,Ivan Duque,5332,4615,624,93,12,32,44
San Agustín,Huila,24005,13303,10702,Ivan Duque,13097,9002,3679,416,28,178,206
Santa María,Huila,8091,5006,3085,Ivan Duque,4973,4229,670,74,5,28,33
Suaza,Huila,12523,7172,5351,Ivan Duque,7105,5533,1429,143,15,52,67
Tarqui,Huila,11657,6816,4841,Ivan Duque,6738,4946,1604,188,13,65,78
Tesalia,Huila,7908,4722,3186,Ivan Duque,4655,3595,862,198,7,60,67
Tello,Huila,10771,5623,5148,Ivan Duque,5570,4104,1353,113,3,50,53
Teruel,Huila,6663,3971,2692,Ivan Duque,3940,3365,514,61,2,29,31
Timaná,Huila,15322,9272,6050,Ivan Duque,9169,7355,1572,242,22,81,103
Villavieja,Huila,6500,3489,3011,Ivan Duque,3440,1855,1511,74,9,40,49
Yaguará,Huila,6661,3981,2680,Ivan Duque,3899,2438,1287,174,2,80,82
Riohacha,La Guajira,116417,52118,64299,Gustavo Petro,51528,23368,26943,1217,59,531,590
Albania,La Guajira,17059,8205,8854,Gustavo Petro,8100,2800,5206,94,8,97,105
Barrancas,La Guajira,24226,10530,13696,Gustavo Petro,10451,3524,6765,162,5,74,79
Dibulla,La Guajira,21876,8146,13730,Gustavo Petro,8072,3829,4140,103,8,66,74
Distracción,La Guajira,9069,4495,4574,Ivan Duque,4441,2467,1922,52,5,49,54
El Molino,La Guajira,7518,3812,3706,Ivan Duque,3777,1984,1732,61,2,33,35
Fonseca,La Guajira,27355,14285,13070,Gustavo Petro,14138,5045,8865,228,18,129,147
Hatonuevo,La Guajira,14689,6513,8176,Gustavo Petro,6450,2139,4232,79,7,56,63
La Jagua del Pilar,La Guajira,4077,2066,2011,Gustavo Petro,2058,959,1068,31,2,6,8
Maicao,La Guajira,121180,41511,79669,Ivan Duque,41059,22360,17985,714,42,410,452
Manaure,La Guajira,54336,11785,42551,Ivan Duque,11526,6276,5138,112,30,229,259
San Juan del Cesar,La Guajira,32333,17631,14702,Ivan Duque,17483,11368,5857,258,17,131,148
Uribia,La Guajira,104635,20283,84352,Ivan Duque,19757,13228,6336,193,71,455,526
Urumita,La Guajira,8546,5022,3524,Gustavo Petro,4986,1951,2959,76,1,35,36
Villanueva,La Guajira,18411,9851,8560,Ivan Duque,9741,5185,4399,157,7,103,110
Santa Marta,Magdalena,338177,175966,162211,Gustavo Petro,174150,79716,89465,4969,78,1738,1816
Algarrobo,Magdalena,9907,5228,4679,Gustavo Petro,5196,1705,3428,63,6,26,32
Aracataca,Magdalena,27298,11147,16151,Ivan Duque,11048,5447,5423,178,12,87,99
Ariguaní,Magdalena,22129,10546,11583,Ivan Duque,10442,6561,3717,164,19,85,104
Cerro San Antonio,Magdalena,8510,3364,5146,Ivan Duque,3350,2382,944,24,4,10,14
Chibolo,Magdalena,13279,5863,7416,Ivan Duque,5831,3513,2263,55,2,30,32
Ciénaga,Magdalena,83410,36036,47374,Gustavo Petro,35566,17383,17422,761,28,442,470
Concordia,Magdalena,11279,4496,6783,Ivan Duque,4468,2782,1655,31,12,16,28
El Banco,Magdalena,46612,19913,26699,Ivan Duque,19743,12652,6839,252,43,127,170
El Piñón,Magdalena,13258,6278,6980,Ivan Duque,6228,3304,2852,72,15,35,50
El Retén,Magdalena,13717,6134,7583,Gustavo Petro,6070,2191,3779,100,12,52,64
Fundación,Magdalena,51904,22843,29061,Ivan Duque,22579,14076,8109,394,30,234,264
Guamal,Magdalena,22408,8759,13649,Ivan Duque,8707,5984,2622,101,12,40,52
Nueva Granada,Magdalena,14629,7344,7285,Ivan Duque,7289,5327,1900,62,11,44,55
Pedraza,Magdalena,9991,3578,6413,Ivan Duque,3556,2591, ,20,8,14,22
Pijiño del Carmen,Magdalena,8534,4465,4069,Ivan Duque,4430,3048,1353,29,5,30,35
Pivijay,Magdalena,28870,13009,15861,Gustavo Petro,12903,5174,7535,194,19,87,106
Plato,Magdalena,39759,17887,21872,Ivan Duque,17756,9385,8174,197,15,116,131
Puebloviejo,Magdalena,21563,8066,13497,Ivan Duque,7986,4831,3068,87,11,69,80
Remolino,Magdalena,6991,3241,3750,Ivan Duque,3219,1634,1556,29,5,17,22
Sabanas de San Ángel,Magdalena,11025,5338,5687,Ivan Duque,5299,4068,1169,62,5,34,39
Salamina,Magdalena,7735,3862,3873,Ivan Duque,3835,2310,1475,50,4,23,27
San Sebastián de Buenavista,Magdalena,16459,7982,8477,Ivan Duque,7939,4482,3382,75,7,36,43
San Zenón,Magdalena,8622,4421,4201,Ivan Duque,4400,2385,1985,30,2,19,21
Santa Ana,Magdalena,15368,8138,7230,Ivan Duque,8094,6136,1859,99,12,32,44
Santa Bárbara de Pinto,Magdalena,8175,3898,4277,Gustavo Petro,3876,1854,1987,35,3,19,22
Sitionuevo,Magdalena,18503,6196,12307,Ivan Duque,6103,3180,2853,70,12,81,93
Tenerife,Magdalena,10570,4478,6092,Ivan Duque,4440,2494,1863,83,9,29,38
Zapayán,Magdalena,8255,3669,4586,Ivan Duque,3649,2833,793,23,3,17,20
Zona Bananera,Magdalena,43931,18574,25357,Gustavo Petro,18334,6670,11430,234,29,211,240
Villavicencio,Meta,351334,214297,137037,Ivan Duque,211193,130440,71613,9140,154,2950,3104
Acacías,Meta,60952,41605,19347,Ivan Duque,40390,26978,11476,1936,30,1185,1215
Barranca de Upía,Meta,4629,2633,1996,Ivan Duque,2552,1781,705,66,4,77,81
Cabuyaro,Meta,5023,2952,2071,Ivan Duque,2900,2242,554,104,9,43,52
Castilla la Nueva,Meta,11355,8306,3049,Ivan Duque,8040,5512,2148,380,8,258,266
Cubarral,Meta,5066,3027,2039,Ivan Duque,2984,2347,527,110,4,39,43
Cumaral,Meta,16735,10701,6034,Ivan Duque,10493,7238,2812,443,11,197,208
El Calvario,Meta,1626,886,740,Ivan Duque,880,710,149,21,0,6,6
El Castillo,Meta,5629,2912,2717,Ivan Duque,2845,1418,1330,97,6,61,67
El Dorado,Meta,3098,2014,1084,Ivan Duque,1992,1540,392,60,3,19,22
Fuente de Oro,Meta,9467,5189,4278,Ivan Duque,5088,3369,1532,187,9,92,101
Granada,Meta,51148,28535,22613,Ivan Duque,27969,18512,8234,1223,48,518,566
Guamal,Meta,11338,7769,3569,Ivan Duque,7639,5794,1546,299,4,126,130
Mapiripán,Meta,5296,1726,3570,Ivan Duque,1688,1210,423,55,5,33,38
Mesetas,Meta,8484,4000,4484,Ivan Duque,3934,1938,1870,126,10,56,66
La Macarena,Meta,8318,3397,4921,Ivan Duque,3338,1624,1553,161,14,45,59
Uribe,Meta,5048,2609,2439,Gustavo Petro,2583,284,2248,51,5,21,26
Lejanías,Meta,8043,4276,3767,Ivan Duque,4164,2913,1105,146,22,90,112
Puerto Concordia,Meta,6345,2996,3349,Ivan Duque,2934,1742,1094,98,10,52,62
Puerto Gaitán,Meta,28044,14590,13454,Ivan Duque,14034,7766,5747,521,30,526,556
Puerto López,Meta,24140,13803,10337,Ivan Duque,13582,10088,3021,473,12,209,221
Puerto Lleras,Meta,6428,3294,3134,Ivan Duque,3241,2419,742,80,9,44,53
Puerto Rico,Meta,8639,4560,4079,Ivan Duque,4431,2441,1826,164,10,119,129
Restrepo,Meta,15740,8890,6850,Ivan Duque,8805,6150,2302,353,5,80,85
San Carlos de Guaroa,Meta,8396,5236,3160,Ivan Duque,5123,4012,984,127,6,107,113
San Juan de Arama,Meta,6059,3239,2820,Ivan Duque,3183,2068,995,120,10,46,56
San Juanito,Meta,1329,800,529,Ivan Duque,799,655,107,37,0,1,1
San Martín,Meta,18087,10932,7155,Ivan Duque,10742,8239,2105,398,14,176,190
Vistahermosa,Meta,12544,6699,5845,Ivan Duque,6534,3780,2467,287,21,144,165
Pasto,Nariño,287326,171926,115400,Gustavo Petro,169324,47331,116029,5964,174,2428,2602
Albán,Nariño,6517,4178,2339,Ivan Duque,4133,3049,999,85,8,37,45
Aldana,Nariño,5800,3516,2284,Gustavo Petro,3445,1321,2047,77,14,57,71
Ancuyá,Nariño,7257,3806,3451,Gustavo Petro,3766,1404,2274,88,6,34,40
Arboleda,Nariño,5814,3140,2674,Ivan Duque,3093,1858,1151,84,8,39,47
Barbacoas,Nariño,21019,6222,14797,Gustavo Petro,6038,2549,3302,187,54,130,184
Belén,Nariño,5348,3298,2050,Gustavo Petro,3256,1474,1666,116,6,36,42
Buesaco,Nariño,17344,9437,7907,Ivan Duque,9307,6253,2837,217,32,98,130
Colón,Nariño,6645,3615,3030,Gustavo Petro,3530,1116,2340,74,16,69,85
Consacá,Nariño,8630,4929,3701,Gustavo Petro,4851,1978,2734,139,13,65,78
Contadero,Nariño,5732,3268,2464,Gustavo Petro,3238,1217,1944,77,5,25,30
Córdoba,Nariño,10301,5621,4680,Gustavo Petro,5557,1209,4256,92,17,47,64
Cuaspud,Nariño,7155,3873,3282,Gustavo Petro,3803,1655,2057,91,15,55,70
Cumbal,Nariño,23876,14540,9336,Gustavo Petro,14414,3473,10742,199,29,97,126
Cumbitara,Nariño,6180,2934,3246,Gustavo Petro,2915,179,2700,36,5,14,19
Chachagüí,Nariño,10134,5974,4160,Gustavo Petro,5872,2127,3614,131,15,87,102
El Charco,Nariño,15994,6081,9913,Gustavo Petro,6000,972,4956,72,18,63,81
El Peñol,Nariño,5552,3299,2253,Gustavo Petro,3278,1060,2171,47,3,18,21
El Rosario,Nariño,6637,3502,3135,Gustavo Petro,3487,307,3155,25,2,13,15
El Tablón de Gómez,Nariño,11007,5994,5013,Ivan Duque,5940,3099,2714,127,15,39,54
El Tambo,Nariño,11298,7179,4119,Ivan Duque,7064,3656,3238,170,18,97,115
Funes,Nariño,5615,3203,2412,Ivan Duque,3166,1701,1408,57,9,28,37
Guachucal,Nariño,14221,9096,5125,Gustavo Petro,9026,1756,7133,137,13,57,70
Guaitarilla,Nariño,10896,5671,5225,Gustavo Petro,5608,1330,4175,103,10,53,63
Gualmatán,Nariño,5140,3189,1951,Gustavo Petro,3150,908,2118,124,7,32,39
Iles,Nariño,6968,3711,3257,Gustavo Petro,3667,953,2667,47,16,28,44
Imués,Nariño,6454,3298,3156,Gustavo Petro,3259,1332,1861,66,7,32,39
Ipiales,Nariño,94987,44421,50566,Gustavo Petro,43382,16842,24775,1765,107,932,1039
La Cruz,Nariño,13512,8054,5458,Ivan Duque,7949,4227,3531,191,18,87,105
La Florida,Nariño,9048,5051,3997,Gustavo Petro,4996,1732,3186,78,10,45,55
La Llanada,Nariño,3409,1942,1467,Gustavo Petro,1914,536,1344,34,4,24,28
La Tola,Nariño,5214,1764,3450,Gustavo Petro,1747,451,1270,26,5,12,17
La Unión,Nariño,22028,12518,9510,Ivan Duque,12284,6801,5107,376,34,200,234
Leiva,Nariño,7318,3825,3493,Gustavo Petro,3798,359,3374,65,12,15,27
Linares,Nariño,8449,5156,3293,Gustavo Petro,5110,1440,3610,60,12,34,46
Los Andes,Nariño,7295,4356,2939,Gustavo Petro,4312,869,3348,95,11,33,44
Magüi Payán,Nariño,6551,2528,4023,Gustavo Petro,2493,337,2135,21,9,26,35
Mallama,Nariño,6031,3078,2953,Gustavo Petro,3048,439,2554,55,14,16,30
Mosquera,Nariño,6011,2342,3669,Gustavo Petro,2320,213,2093,14,5,17,22
Nariño,Nariño,5736,3038,2698,Gustavo Petro,2981,1089,1795,97,10,47,57
Olaya Herrera,Nariño,13897,5199,8698,Gustavo Petro,5122,765,4292,65,16,61,77
Ospina,Nariño,5729,2901,2828,Gustavo Petro,2859,1272,1476,111,11,31,42
Francisco Pizarro,Nariño,6236,2092,4144,Gustavo Petro,2071,437,1608,26,3,18,21
Policarpa,Nariño,9527,4896,4631,Gustavo Petro,4864,227,4608,29,6,26,32
Potosí,Nariño,9625,5155,4470,Gustavo Petro,5088,1943,3011,134,11,56,67
Providencia,Nariño,4509,2775,1734,Gustavo Petro,2761,298,2431,32,6,8,14
Puerres,Nariño,7693,4668,3025,Gustavo Petro,4604,1616,2874,114,11,53,64
Pupiales,Nariño,14632,8260,6372,Gustavo Petro,8096,3302,4489,305,19,145,164
Ricaurte,Nariño,14924,6754,8170,Gustavo Petro,6666,908,5671,87,32,56,88
Roberto Payán,Nariño,8449,3010,5439,Gustavo Petro,2984,444,2510,30,5,21,26
Samaniego,Nariño,22102,11781,10321,Gustavo Petro,11650,1581,9933,136,14,117,131
Sandoná,Nariño,16210,9110,7100,Gustavo Petro,8968,3007,5716,245,27,115,142
San Bernardo,Nariño,6356,4115,2241,Ivan Duque,4078,2571,1405,102,11,26,37
San Lorenzo,Nariño,12873,6961,5912,Gustavo Petro,6827,2930,3745,152,24,110,134
San Pablo,Nariño,11453,6231,5222,Gustavo Petro,6163,1784,4271,108,21,47,68
San Pedro de Cartago,Nariño,5407,3400,2007,Ivan Duque,3358,2332,944,82,6,36,42
Santa Bárbara,Nariño,7351,1856,5495,Gustavo Petro,1825,633,1168,24,7,24,31
Santacruz,Nariño,7035,3761,3274,Gustavo Petro,3735,380,3315,40,4,22,26
Sapuyes,Nariño,5577,3230,2347,Gustavo Petro,3207,1265,1884,58,5,18,23
Taminango,Nariño,13518,7821,5697,Gustavo Petro,7777,1340,6353,84,10,34,44
Tangua,Nariño,9734,4726,5008,Gustavo Petro,4635,1733,2808,94,12,79,91
Tumaco,Nariño,124028,49186,74842,Ivan Duque,48368,25074,22406,888,138,680,818
Túquerres,Nariño,34523,18851,15672,Gustavo Petro,18476,4398,13679,399,57,318,375
Yacuanquer,Nariño,8329,4907,3422,Gustavo Petro,4816,1545,3136,135,17,74,91
Cúcuta,Norte de Santander,552597,317268,235329,Ivan Duque,313510,251152,47211,15147,517,3241,3758
Abrego,Norte de Santander,22012,12380,9632,Ivan Duque,12282,10561,1461,260,17,81,98
Arboledas,Norte de Santander,6945,4312,2633,Ivan Duque,4254,3795,349,110,17,41,58
Bochalema,Norte de Santander,6419,4155,2264,Ivan Duque,4120,3560,441,119,8,27,35
Bucarasica,Norte de Santander,4112,2200,1912,Ivan Duque,2177,1983,147,47,8,15,23
Cácota,Norte de Santander,2215,1468,747,Ivan Duque,1454,1299,110,45,2,12,14
Cachirá,Norte de Santander,6987,4169,2818,Ivan Duque,4146,3819,269,58,1,22,23
Chinácota,Norte de Santander,12505,8172,4333,Ivan Duque,8078,6522,1197,359,11,83,94
Chitagá,Norte de Santander,7993,5020,2973,Ivan Duque,4965,4433,421,111,11,44,55
Convención,Norte de Santander,15325,5386,9939,Ivan Duque,5272,2943,2150,179,25,89,114
Cucutilla,Norte de Santander,6215,3985,2230,Ivan Duque,3921,3464,366,91,18,46,64
Durania,Norte de Santander,4397,2526,1871,Ivan Duque,2481,2133,273,75,3,42,45
El Carmen,Norte de Santander,9791,4269,5522,Ivan Duque,4209,3155,957,97,7,53,60
El Tarra,Norte de Santander,12101,5293,6808,Gustavo Petro,5225,703,4399,123,9,59,68
El Zulia,Norte de Santander,20925,11470,9455,Ivan Duque,11322,9527,1459,336,21,127,148
Gramalote,Norte de Santander,5046,3244,1802,Ivan Duque,3212,2874,268,70,7,25,32
Hacarí,Norte de Santander,7005,2877,4128,Gustavo Petro,2837,586,2193,58,10,30,40
Herrán,Norte de Santander,3871,1962,1909,Ivan Duque,1949,1796,121,32,4,9,13
Labateca,Norte de Santander,5032,2658,2374,Ivan Duque,2626,2275,272,79,8,24,32
La Esperanza,Norte de Santander,8797,4766,4031,Ivan Duque,4705,3724,874,107,12,49,61
La Playa,Norte de Santander,6696,2825,3871,Ivan Duque,2784,2058,674,52,2,39,41
Los Patios,Norte de Santander,80432,40462,39970,Ivan Duque,40003,32149,6295,1559,23,436,459
Lourdes,Norte de Santander,3253,2140,1113,Ivan Duque,2122,2021,62,39,3,15,18
Mutiscua,Norte de Santander,2696,1796,900,Ivan Duque,1782,1656,88,38,5,9,14
Ocaña,Norte de Santander,79284,44702,34582,Ivan Duque,44214,31465,11188,1561,40,448,488
Pamplona,Norte de Santander,45883,27986,17897,Ivan Duque,27458,17268,8641,1549,32,496,528
Pamplonita,Norte de Santander,3892,2782,1110,Ivan Duque,2737,2489,173,75,10,35,45
Puerto Santander,Norte de Santander,14624,5570,9054,Ivan Duque,5520,4907,527,86,11,39,50
Ragonvalia,Norte de Santander,7514,3337,4177,Ivan Duque,3316,3098,169,49,1,20,21
Salazar,Norte de Santander,8118,4851,3267,Ivan Duque,4783,4302,370,111,10,58,68
San Calixto,Norte de Santander,7060,3357,3703,Gustavo Petro,3304,207,3051,46,3,50,53
San Cayetano,Norte de Santander,8291,3796,4495,Ivan Duque,3757,3222,433,102,4,35,39
Santiago,Norte de Santander,3511,1923,1588,Ivan Duque,1908,1609,241,58,4,11,15
Sardinata,Norte de Santander,17550,8148,9402,Ivan Duque,8007,6719,1028,260,26,115,141
Silos,Norte de Santander,4074,2801,1273,Ivan Duque,2786,2618,107,61,3,12,15
Teorama,Norte de Santander,9758,4194,5564,Gustavo Petro,4139,843,3189,107,19,36,55
Tibú,Norte de Santander,35411,15288,20123,Ivan Duque,14924,7885,6465,574,56,308,364
Toledo,Norte de Santander,12050,6793,5257,Ivan Duque,6676,5787,684,205,21,96,117
Villa Caro,Norte de Santander,3699,2218,1481,Ivan Duque,2203,2087,80,36,3,12,15
Villa del Rosario,Norte de Santander,81871,40065,41806,Ivan Duque,39721,34203,4360,1158,35,309,344
Armenia,Quindío,254451,141079,113372,Ivan Duque,138101,82006,46675,9420,191,2787,2978
Buenavista,Quindío,2795,1392,1403,Ivan Duque,1363,966,325,72,5,24,29
Calarcá,Quindío,59987,33948,26039,Ivan Duque,33096,22010,9329,1757,59,793,852
Circasia,Quindío,22992,13468,9524,Ivan Duque,13153,8856,3646,651,30,285,315
Córdoba,Quindío,5178,2653,2525,Ivan Duque,2569,1530,917,122,4,80,84
Filandia,Quindío,10501,5836,4665,Ivan Duque,5696,4065,1339,292,12,128,140
Génova,Quindío,7315,3871,3444,Ivan Duque,3782,2730,914,138,11,78,89
La Tebaida,Quindío,28413,15159,13254,Ivan Duque,14576,9039,4775,762,49,534,583
Montenegro,Quindío,33944,17349,16595,Ivan Duque,16722,11912,3896,914,56,571,627
Pijao,Quindío,6052,3214,2838,Ivan Duque,3149,2324,709,116,9,56,65
Quimbaya,Quindío,30348,15491,14857,Ivan Duque,15073,9711,4625,737,46,372,418
Salento,Quindío,5883,3353,2530,Ivan Duque,3302,2367,760,175,7,44,51
Pereira,Risaralda,404790,222092,182698,Ivan Duque,217142,129120,74799,13223,452,4498,4950
Apía,Risaralda,10397,5774,4623,Ivan Duque,5626,4426,985,215,19,129,148
Balboa,Risaralda,5653,2802,2851,Ivan Duque,2716,2008,583,125,14,72,86
Belén de Umbría,Risaralda,21454,11426,10028,Ivan Duque,11207,8873,1891,443,29,190,219
Dosquebradas,Risaralda,160430,90413,70017,Ivan Duque,88154,52115,30682,5357,170,2089,2259
Guática,Risaralda,10326,6017,4309,Ivan Duque,5920,4780,924,216,18,79,97
La Celia,Risaralda,6497,3550,2947,Ivan Duque,3453,2693,642,118,14,83,97
La Virginia,Risaralda,31770,15861,15909,Ivan Duque,15387,10075,4436,876,37,437,474
Marsella,Risaralda,15639,8215,7424,Ivan Duque,8013,5853,1810,350,44,158,202
Mistrató,Risaralda,11324,6073,5251,Ivan Duque,5918,3124,2631,163,23,132,155
Pueblo Rico,Risaralda,9619,4776,4843,Gustavo Petro,4705,2068,2552,85,14,57,71
Quinchía,Risaralda,20038,10984,9054,Ivan Duque,10518,6224,3784,510,91,375,466
Santa Rosa de Cabal,Risaralda,61483,35889,25594,Ivan Duque,34957,22814,10127,2016,81,851,932
Santuario,Risaralda,12124,6004,6120,Ivan Duque,5860,4791,809,260,36,108,144
Bucaramanga,Santander,494283,295294,198989,Ivan Duque,291633,168911,107050,15672,181,3480,3661
Aguada,Santander,1520,839,681,Ivan Duque,831,675,133,23,2,6,8
Albania,Santander,3314,1658,1656,Ivan Duque,1636,1177,416,43,5,17,22
Aratoca,Santander,6604,3626,2978,Ivan Duque,3569,2616,808,145,8,49,57
Barbosa,Santander,24767,13951,10816,Ivan Duque,13720,6816,6317,587,11,220,231
Barichara,Santander,6530,4014,2516,Ivan Duque,3979,2867,912,200,3,32,35
Barrancabermeja,Santander,168901,98563,70338,Gustavo Petro,96667,33283,60208,3176,118,1778,1896
Betulia,Santander,4300,2363,1937,Ivan Duque,2324,1665,564,95,3,36,39
Bolívar,Santander,8215,4229,3986,Ivan Duque,4142,2784,1243,115,15,72,87
Cabrera,Santander,1660,942,718,Ivan Duque,938,819,97,22,2,2,4
California,Santander,1688,1173,515,Ivan Duque,1155,1000,114,41,2,16,18
Capitanejo,Santander,4816,2710,2106,Ivan Duque,2673,2288,321,64,4,33,37
Carcasí,Santander,3591,2068,1523,Ivan Duque,2019,1675,284,60,7,42,49
Cepitá,Santander,1843,1196,647,Ivan Duque,1184,983,170,31,4,8,12
Cerrito,Santander,4825,2872,1953,Ivan Duque,2814,2299,390,125,7,51,58
Charalá,Santander,9649,5371,4278,Ivan Duque,5284,3439,1643,202,15,72,87
Charta,Santander,3378,2205,1173,Ivan Duque,2187,1931,213,43,2,16,18
Chima,Santander,2424,1276,1148,Ivan Duque,1240,922,249,69,10,26,36
Chipatá,Santander,4399,1824,2575,Ivan Duque,1781,1072,639,70,7,36,43
Cimitarra,Santander,28148,13592,14556,Ivan Duque,13227,8563,4185,479,33,332,365
Concepción,Santander,4911,2742,2169,Ivan Duque,2690,2040,522,128,11,41,52
Confines,Santander,2494,1583,911,Ivan Duque,1572,1329,205,38,2,9,11
Contratación,Santander,2875,1687,1188,Ivan Duque,1654,1207,359,88,7,26,33
Coromoro,Santander,4158,2597,1561,Ivan Duque,2554,2078,408,68,10,33,43
Curití,Santander,8820,5583,3237,Ivan Duque,5502,3822,1466,214,14,67,81
El Carmen de Chucurí,Santander,10891,6411,4480,Ivan Duque,6310,5521,593,196,12,89,101
El Guacamayo,Santander,1613,877,736,Ivan Duque,866,707,113,46,2,9,11
El Peñón,Santander,3604,1802,1802,Ivan Duque,1765,1228,479,58,5,32,37
El Playón,Santander,11707,6332,5375,Ivan Duque,6217,5062,981,174,15,100,115
Encino,Santander,2131,1262,869,Ivan Duque,1250,1030,186,34,4,8,12
Enciso,Santander,3210,1810,1400,Ivan Duque,1783,1407,304,72,8,19,27
Florián,Santander,5330,2471,2859,Ivan Duque,2443,1484,902,57,6,22,28
Floridablanca,Santander,191619,125484,66135,Ivan Duque,123777,74349,43082,6346,82,1625,1707
Galán,Santander,2498,1514,984,Ivan Duque,1501,1278,187,36,5,8,13
Gambita,Santander,3225,1833,1392,Ivan Duque,1807,1468,292,47,12,14,26
Girón,Santander,114158,69507,44651,Ivan Duque,68400,41993,23020,3387,76,1031,1107
Guaca,Santander,5258,3119,2139,Ivan Duque,3071,2543,442,86,7,41,48
Guadalupe,Santander,4235,2624,1611,Ivan Duque,2590,2134,381,75,3,31,34
Guapotá,Santander,1853,1136,717,Ivan Duque,1112,924,152,36,2,22,24
Guavatá,Santander,4426,2210,2216,Ivan Duque,2171,1198,910,63,5,34,39
Güepsa,Santander,4181,2152,2029,Ivan Duque,2113,1107,915,91,8,31,39
Hato,Santander,1817,1032,785,Ivan Duque,983,602,342,39,9,40,49
Jesús María,Santander,3386,1719,1667,Ivan Duque,1681,1001,639,41,5,33,38
Jordán,Santander,1203,789,414,Ivan Duque,784,702,69,13,1,4,5
La Belleza,Santander,5501,3052,2449,Ivan Duque,3031,2465,486,80,3,18,21
Landázuri,Santander,9634,4675,4959,Ivan Duque,4541,3031,1339,171,17,117,134
La Paz,Santander,4060,2041,2019,Ivan Duque,2002,1585,322,95,13,26,39
Lebríja,Santander,31131,19456,11675,Ivan Duque,19162,14809,3647,706,18,276,294
Los Santos,Santander,8874,5626,3248,Ivan Duque,5495,4335,903,257,22,109,131
Macaravita,Santander,2224,1146,1078,Ivan Duque,1136,980,130,26,2,8,10
Málaga,Santander,15601,9370,6231,Ivan Duque,9199,6379,2391,429,12,159,171
Matanza,Santander,4955,3154,1801,Ivan Duque,3114,2594,444,76,6,34,40
Mogotes,Santander,7555,4232,3323,Ivan Duque,4115,3173,759,183,15,102,117
Molagavita,Santander,3663,2143,1520,Ivan Duque,2119,1869,185,65,3,21,24
Ocamonte,Santander,3826,2291,1535,Ivan Duque,2270,1890,325,55,2,19,21
Oiba,Santander,8715,5130,3585,Ivan Duque,5051,3749,1108,194,9,70,79
Onzaga,Santander,3662,1919,1743,Ivan Duque,1870,1535,278,57,15,34,49
Palmar,Santander,1440,831,609,Ivan Duque,818,551,248,19,0,13,13
Palmas del Socorro,Santander,2453,1494,959,Ivan Duque,1480,1215,225,40,2,12,14
Páramo,Santander,3351,2330,1021,Ivan Duque,2307,1848,364,95,4,19,23
Piedecuesta,Santander,107636,69828,37808,Ivan Duque,68536,41940,23441,3155,74,1218,1292
Pinchote,Santander,3333,2133,1200,Ivan Duque,2120,1417,602,101,0,13,13
Puente Nacional,Santander,12660,6814,5846,Ivan Duque,6711,3677,2825,209,8,95,103
Puerto Parra,Santander,5738,2797,2941,Ivan Duque,2748,2200,495,53,6,43,49
Puerto Wilches,Santander,23040,12440,10600,Ivan Duque,12236,6295,5633,308,16,188,204
Rionegro,Santander,22282,12282,10000,Ivan Duque,12046,9291,2384,371,28,208,236
Sabana de Torres,Santander,21386,11610,9776,Ivan Duque,11326,7371,3570,385,17,267,284
San Andrés,Santander,6790,3774,3016,Ivan Duque,3706,2833,741,132,11,57,68
San Benito,Santander,3121,1401,1720,Ivan Duque,1387,1060,285,42,2,12,14
San Gil,Santander,41245,25268,15977,Ivan Duque,24893,14024,9554,1315,18,357,375
San Joaquín,Santander,2230,1218,1012,Ivan Duque,1193,981,176,36,7,18,25
San José de Miranda,Santander,4083,2550,1533,Ivan Duque,2526,2151,311,64,6,18,24
San Miguel,Santander,2171,1238,933,Ivan Duque,1224,995,204,25,2,12,14
San Vicente de Chucurí,Santander,24310,12637,11673,Ivan Duque,12412,8747,3182,483,26,199,225
Santa Bárbara,Santander,2061,1234,827,Ivan Duque,1220,1030,158,32,3,11,14
Santa Helena del Opón,Santander,3093,1586,1507,Ivan Duque,1556,1227,243,86,4,26,30
Simacota,Santander,5972,3382,2590,Ivan Duque,3304,2222,937,145,11,67,78
Socorro,Santander,23946,14499,9447,Ivan Duque,14303,9697,3978,628,13,183,196
Suaita,Santander,8244,4224,4020,Ivan Duque,4142,2955,1000,187,14,68,82
Sucre,Santander,5667,2875,2792,Ivan Duque,2834,2199,548,87,9,32,41
Suratá,Santander,3182,2029,1153,Ivan Duque,2004,1644,302,58,4,21,25
Tona,Santander,5154,3089,2065,Ivan Duque,3042,2427,500,115,2,45,47
Valle de San José,Santander,4746,3032,1714,Ivan Duque,2997,2111,777,109,5,30,35
Vélez,Santander,16125,8789,7336,Ivan Duque,8595,4643,3517,435,26,168,194
Vetas,Santander,1443,991,452,Ivan Duque,979,927,29,23,0,12,12
Villanueva,Santander,6446,3969,2477,Ivan Duque,3924,3033,702,189,11,34,45
Zapatoca,Santander,7494,4321,3173,Ivan Duque,4287,3230,899,158,2,32,34
Sincelejo,Sucre,199012,108140,90872,Gustavo Petro,107176,45591,59595,1990,96,868,964
Buenavista,Sucre,9865,4679,5186,Gustavo Petro,4646,2229,2342,75,9,24,33
Caimito,Sucre,9281,4894,4387,Gustavo Petro,4863,1611,3216,36,13,18,31
Colosó,Sucre,7249,4115,3134,Ivan Duque,4082,2203,1841,38,13,20,33
Corozal,Sucre,46732,26883,19849,Gustavo Petro,26709,11710,14582,417,17,157,174
Coveñas,Sucre,11979,6179,5800,Ivan Duque,6117,3210,2830,77,9,53,62
Chalán,Sucre,4554,2436,2118,Ivan Duque,2426,1485,927,14,2,8,10
El Roble,Sucre,8219,4836,3383,Gustavo Petro,4811,1817,2967,27,6,19,25
Galeras,Sucre,16567,8850,7717,Ivan Duque,8758,6164,2443,151,24,68,92
Guaranda,Sucre,13259,6203,7056,Ivan Duque,6163,5026,1094,43,6,34,40
La Unión,Sucre,9643,5190,4453,Gustavo Petro,5142,1789,3303,50,16,32,48
Los Palmitos,Sucre,18250,10956,7294,Gustavo Petro,10907,3591,7225,91,9,40,49
Majagual,Sucre,26747,14231,12516,Ivan Duque,14155,11041,2972,142,14,62,76
Morroa,Sucre,13401,7786,5615,Gustavo Petro,7720,3345,4297,78,12,54,66
Ovejas,Sucre,20740,11403,9337,Gustavo Petro,11343,5060,6195,88,23,37,60
Palmito,Sucre,10139,5773,4366,Gustavo Petro,5729,2661,3027,41,16,28,44
Sampués,Sucre,32143,18560,13583,Gustavo Petro,18358,8556,9561,241,38,164,202
San Benito Abad,Sucre,19064,9407,9657,Ivan Duque,9348,5260,4040,48,12,47,59
San Juan de Betulia,Sucre,11514,6882,4632,Gustavo Petro,6846,2758,4027,61,4,32,36
San Marcos,Sucre,43806,20089,23717,Ivan Duque,19886,10771,8850,265,40,163,203
San Onofre,Sucre,42349,17546,24803,Gustavo Petro,17367,7798,9432,137,41,138,179
San Pedro,Sucre,16387,8752,7635,Ivan Duque,8685,4289,4288,108,18,49,67
San Luis de Sincé,Sucre,26060,13625,12435,Ivan Duque,13487,6947,6304,236,19,119,138
Sucre,Sucre,20711,9986,10725,Ivan Duque,9944,7200,2658,86,18,24,42
Santiago de Tolú,Sucre,23358,11595,11763,Gustavo Petro,11489,4116,7242,131,14,92,106
Tolú Viejo,Sucre,18838,10267,8571,Ivan Duque,10195,5266,4795,134,19,53,72
Ibagué,Tolima,405893,248600,157293,Ivan Duque,244046,147764,84019,12263,196,4358,4554
Alpujarra,Tolima,3632,2154,1478,Ivan Duque,2129,1820,276,33,4,21,25
Alvarado,Tolima,8492,3991,4501,Ivan Duque,3909,2509,1292,108,17,65,82
Ambalema,Tolima,6792,3253,3539,Ivan Duque,3168,1821,1245,102,5,80,85
Anzoátegui,Tolima,7761,3880,3881,Ivan Duque,3838,3117,645,76,12,30,42
Armero,Tolima,10041,4955,5086,Ivan Duque,4837,2708,2003,126,9,109,118
Ataco,Tolima,14776,7701,7075,Ivan Duque,7643,6639,909,95,11,47,58
Cajamarca,Tolima,16346,8474,7872,Ivan Duque,8292,5800,2225,267,21,161,182
Carmen de Apicalá,Tolima,8825,5198,3627,Ivan Duque,5123,3954,1013,156,6,69,75
Casabianca,Tolima,5181,2878,2303,Ivan Duque,2837,2348,410,79,12,29,41
Chaparral,Tolima,38279,18345,19934,Ivan Duque,18036,13298,4238,500,40,269,309
Coello,Tolima,8063,3924,4139,Ivan Duque,3853,2106,1653,94,12,59,71
Coyaima,Tolima,17035,8339,8696,Ivan Duque,8197,4448,3662,87,47,95,142
Cunday,Tolima,7005,3857,3148,Ivan Duque,3819,3180,600,39,10,28,38
Dolores,Tolima,6748,3667,3081,Ivan Duque,3645,2933,638,74,4,18,22
Espinal,Tolima,59094,34502,24592,Ivan Duque,33716,22549,9834,1333,56,730,786
Falan,Tolima,5828,3030,2798,Ivan Duque,2968,1922,967,79,16,46,62
Flandes,Tolima,17696,10009,7687,Ivan Duque,9766,6680,2811,275,18,225,243
Fresno,Tolima,26227,13326,12901,Ivan Duque,13055,10324,2277,454,36,235,271
Guamo,Tolima,25524,13581,11943,Ivan Duque,13340,10232,2789,319,25,216,241
Herveo,Tolima,5801,2960,2841,Ivan Duque,2893,2346,465,82,10,57,67
Honda,Tolima,22774,11505,11269,Ivan Duque,11189,6709,4007,473,20,296,316
Icononzo,Tolima,8747,4507,4240,Ivan Duque,4439,2500,1824,115,11,57,68
Lérida,Tolima,15216,7724,7492,Ivan Duque,7572,4170,3170,232,11,141,152
Líbano,Tolima,32618,16468,16150,Ivan Duque,16135,9498,6161,476,32,301,333
Mariquita,Tolima,28983,15074,13909,Ivan Duque,14632,9256,4666,710,46,396,442
Melgar,Tolima,28370,16508,11862,Ivan Duque,16256,12556,3155,545,12,240,252
Murillo,Tolima,3736,1771,1965,Ivan Duque,1726,1258,421,47,4,41,45
Natagaima,Tolima,15170,7135,8035,Ivan Duque,7038,3768,3120,150,16,81,97
Ortega,Tolima,23436,12098,11338,Ivan Duque,11861,8249,3416,196,57,180,237
Palocabildo,Tolima,7632,3981,3651,Ivan Duque,3927,2882,941,104,10,44,54
Piedras,Tolima,5783,2980,2803,Ivan Duque,2896,1449,1337,110,10,74,84
Planadas,Tolima,20156,9306,10850,Ivan Duque,9072,6532,2265,275,29,205,234
Prado,Tolima,7870,4196,3674,Ivan Duque,4157,3180,895,82,6,33,39
Purificación,Tolima,20169,10739,9430,Ivan Duque,10518,5635,4592,291,26,195,221
Rioblanco,Tolima,15831,6935,8896,Ivan Duque,6814,5503,1150,161,26,95,121
Roncesvalles,Tolima,4241,2047,2194,Ivan Duque,2014,1602,339,73,6,27,33
Rovira,Tolima,19484,9183,10301,Ivan Duque,9037,7406,1419,212,19,127,146
Saldaña,Tolima,12628,6548,6080,Ivan Duque,6427,4437,1792,198,12,109,121
San Antonio,Tolima,10091,5502,4589,Ivan Duque,5451,4726,627,98,5,46,51
San Luis,Tolima,11257,6659,4598,Ivan Duque,6553,5372,1054,127,18,88,106
Santa Isabel,Tolima,5851,2867,2984,Ivan Duque,2835,2376,412,47,5,27,32
Suárez,Tolima,4475,2384,2091,Ivan Duque,2346,1838,468,40,5,33,38
Valle de San Juan,Tolima,4898,2908,1990,Ivan Duque,2882,2498,332,52,7,19,26
Venadillo,Tolima,11811,6065,5746,Ivan Duque,5961,3937,1881,143,10,94,104
Villahermosa,Tolima,6987,3628,3359,Ivan Duque,3587,2989,531,67,8,33,41
Villarrica,Tolima,5043,2518,2525,Ivan Duque,2505,2121,343,41,3,10,13
Cali,Valle del Cauca,1679894,856111,823783,Gustavo Petro,843861,353824,448242,41795,742,11508,12250
Alcalá,Valle del Cauca,11534,5327,6207,Ivan Duque,5183,3440,1554,189,16,128,144
Andalucía,Valle del Cauca,19464,9560,9904,Gustavo Petro,9343,4061,4905,377,22,195,217
Ansermanuevo,Valle del Cauca,19173,8247,10926,Ivan Duque,8109,6504,1347,258,22,116,138
Argelia,Valle del Cauca,6269,2753,3516,Ivan Duque,2717,2208,417,92,5,31,36
Bolívar,Valle del Cauca,13339,6966,6373,Ivan Duque,6848,4966,1686,196,13,105,118
Buenaventura,Valle del Cauca,222511,89651,132860,Gustavo Petro,87613,22908,62939,1766,163,1875,2038
Guadalajara de Buga,Valle del Cauca,102243,55755,46488,Gustavo Petro,54402,22872,28689,2841,73,1280,1353
Bugalagrande,Valle del Cauca,19444,10250,9194,Gustavo Petro,10006,3712,6002,292,16,228,244
Caicedonia,Valle del Cauca,27749,13809,13940,Ivan Duque,13493,9736,3250,507,34,282,316
Calima,Valle del Cauca,14169,6680,7489,Ivan Duque,6515,3610,2639,266,11,154,165
Candelaria,Valle del Cauca,71375,36341,35034,Gustavo Petro,35280,10924,22860,1496,71,990,1061
Cartago,Valle del Cauca,113031,55482,57549,Ivan Duque,54319,34529,16882,2908,93,1070,1163
Dagua,Valle del Cauca,35492,16388,19104,Ivan Duque,16063,10373,5173,517,47,278,325
El Águila,Valle del Cauca,7872,4035,3837,Ivan Duque,3942,3278,546,118,11,82,93
El Cairo,Valle del Cauca,6654,3003,3651,Ivan Duque,2966,2425,464,77,14,23,37
El Cerrito,Valle del Cauca,52880,27057,25823,Gustavo Petro,26456,8418,17011,1027,37,564,601
El Dovio,Valle del Cauca,9809,4641,5168,Ivan Duque,4553,3310,1098,145,13,75,88
Florida,Valle del Cauca,50826,26421,24405,Gustavo Petro,25851,7190,17778,883,46,524,570
Ginebra,Valle del Cauca,16984,9358,7626,Ivan Duque,9123,4718,4026,379,21,214,235
Guacarí,Valle del Cauca,27979,14958,13021,Gustavo Petro,14595,4871,9273,451,27,336,363
Jamundí,Valle del Cauca,103414,51291,52123,Gustavo Petro,50317,19500,28498,2319,53,921,974
La Cumbre,Valle del Cauca,13134,6286,6848,Ivan Duque,6178,3711,2256,211,9,99,108
La Unión,Valle del Cauca,26664,15370,11294,Ivan Duque,15036,11362,2961,713,19,315,334
La Victoria,Valle del Cauca,11645,5953,5692,Ivan Duque,5841,4276,1346,219,9,103,112
Obando,Valle del Cauca,11027,5312,5715,Ivan Duque,5163,2753,2243,167,18,131,149
Palmira,Valle del Cauca,265630,135337,130293,Gustavo Petro,132514,51321,74340,6853,193,2630,2823
Pradera,Valle del Cauca,40248,20411,19837,Gustavo Petro,19886,6665,12458,763,32,493,525
Restrepo,Valle del Cauca,15335,6540,8795,Ivan Duque,6364,4059,2029,276,18,158,176
Riofrío,Valle del Cauca,15730,7648,8082,Ivan Duque,7434,4683,2446,305,21,193,214
Roldanillo,Valle del Cauca,28848,16154,12694,Ivan Duque,15831,10048,5061,722,30,293,323
San Pedro,Valle del Cauca,14788,7278,7510,Ivan Duque,7085,3625,3152,308,9,184,193
Sevilla,Valle del Cauca,37297,17570,19727,Ivan Duque,17068,10710,5548,810,68,434,502
Toro,Valle del Cauca,12674,5931,6743,Ivan Duque,5821,4479,1168,174,14,96,110
Trujillo,Valle del Cauca,15806,7979,7827,Ivan Duque,7826,5760,1809,257,24,129,153
Tuluá,Valle del Cauca,161358,85706,75652,Ivan Duque,83643,43734,35560,4349,121,1942,2063
Ulloa,Valle del Cauca,4612,2195,2417,Ivan Duque,2141,1467,588,86,7,47,54
Versalles,Valle del Cauca,7895,3687,4208,Ivan Duque,3624,2985,532,107,5,58,63
Vijes,Valle del Cauca,10596,5348,5248,Ivan Duque,5248,2907,2213,128,9,91,100
Yotoco,Valle del Cauca,14544,6832,7712,Ivan Duque,6642,3213,3112,317,19,171,190
Yumbo,Valle del Cauca,99517,51433,48084,Gustavo Petro,50390,15797,32720,1873,72,971,1043
Zarzal,Valle del Cauca,37163,19150,18013,Gustavo Petro,18679,6801,11202,676,39,432,471
Arauca,Arauca,70548,36106,34442,Ivan Duque,35620,28888,5523,1209,57,429,486
Arauquita,Arauca,28989,12738,16251,Gustavo Petro,12407,5227,6755,425,49,282,331
Cravo Norte,Arauca,3637,1506,2131,Ivan Duque,1494,1324,126,44,5,7,12
Fortul,Arauca,11663,5799,5864,Gustavo Petro,5659,1872,3579,208,17,123,140
Puerto Rondón,Arauca,3820,1769,2051,Ivan Duque,1751,1554,166,31,4,14,18
Saravena,Arauca,34492,17145,17347,Ivan Duque,16720,9218,6822,680,41,384,425
Tame,Arauca,34040,18427,15613,Ivan Duque,18088,11508,5957,623,65,274,339
Yopal,Casanare,109645,71424,38221,Ivan Duque,70393,47707,19803,2883,45,986,1031
Aguazul,Casanare,27336,18941,8395,Ivan Duque,18383,12689,4896,798,30,528,558
Chámeza,Casanare,1668,1197,471,Ivan Duque,1190,902,259,29,0,7,7
Hato Corozal,Casanare,7202,4506,2696,Ivan Duque,4474,3749,648,77,12,20,32
La Salina,Casanare,784,458,326,Gustavo Petro,454,117,315,22,1,3,4
Maní,Casanare,10343,6638,3705,Ivan Duque,6541,5047,1290,204,12,85,97
Monterrey,Casanare,11211,7151,4060,Ivan Duque,7013,4943,1784,286,6,132,138
Nunchía,Casanare,6277,4105,2172,Ivan Duque,4057,3488,491,78,15,33,48
Orocué,Casanare,7646,4111,3535,Ivan Duque,4062,3097,860,105,8,41,49
Paz de Ariporo,Casanare,24150,15508,8642,Ivan Duque,15356,12735,2243,378,17,135,152
Pore,Casanare,6972,4685,2287,Ivan Duque,4646,3978,582,86,5,34,39
Recetor,Casanare,1208,795,413,Ivan Duque,787,574,189,24,3,5,8
Sabanalarga,Casanare,2720,1660,1060,Ivan Duque,1648,1238,357,53,1,11,12
Sácama,Casanare,1509,719,790,Gustavo Petro,710,257,431,22,4,5,9
San Luis de Palenque,Casanare,5956,3726,2230,Ivan Duque,3693,3186,426,81,4,29,33
Támara,Casanare,4421,2702,1719,Ivan Duque,2668,2227,395,46,7,27,34
Tauramena,Casanare,16317,11055,5262,Ivan Duque,10849,7957,2447,445,14,192,206
Trinidad,Casanare,9331,5625,3706,Ivan Duque,5542,4653,778,111,18,65,83
Villanueva,Casanare,21468,13736,7732,Ivan Duque,13376,9580,3254,542,24,336,360
Mocoa,Putumayo,36706,21153,15553,Gustavo Petro,20872,6354,13979,539,17,264,281
Colón,Putumayo,4282,2547,1735,Gustavo Petro,2526,1026,1430,70,7,14,21
Orito,Putumayo,26157,14189,11968,Gustavo Petro,14039,1790,12043,206,18,132,150
Puerto Asís,Putumayo,43672,20333,23339,Gustavo Petro,19944,6274,12987,683,59,330,389
Puerto Caicedo,Putumayo,9108,4665,4443,Gustavo Petro,4576,606,3861,109,11,78,89
Puerto Guzmán,Putumayo,11029,4812,6217,Gustavo Petro,4740,1770,2837,133,15,57,72
Leguízamo,Putumayo,14418,5674,8744,Ivan Duque,5594,3259,2194,141,25,55,80
Sibundoy,Putumayo,10478,6347,4131,Gustavo Petro,6277,2166,3952,159,14,56,70
San Francisco,Putumayo,4652,2711,1941,Gustavo Petro,2680,1229,1355,96,4,27,31
San Miguel,Putumayo,12018,5666,6352,Gustavo Petro,5592,594,4919,79,14,60,74
Santiago,Putumayo,5972,2984,2988,Gustavo Petro,2936,1043,1832,61,6,42,48
Valle del Guamuez,Putumayo,23951,12195,11756,Gustavo Petro,12092,1221,10681,190,11,92,103
Villagarzón,Putumayo,17077,9390,7687,Gustavo Petro,9116,3580,5240,296,31,243,274
San Andrés,Archipiélago de San Andrés,44371,13869,30502,Ivan Duque,13780,8358,4891,531,14,75,89
Providencia,Archipiélago de San Andrés,4146,1385,2761,Ivan Duque,1379,945,391,43,3,3,6
Leticia,Amazonas,36216,15809,20407,Ivan Duque,15635,8536,6676,423,35,139,174
El Encanto ,Amazonas,776,296,480,Gustavo Petro,291,107,181,3,3,2,5
La Chorrera ,Amazonas,969,563,406,Gustavo Petro,562,78,482,2,0,1,1
La Pedrera ,Amazonas,965,249,716,Gustavo Petro,249,66,182,1,0,0,0
La Victoria ,Amazonas,61,17,44,Gustavo Petro,17,5,11,1,0,0,0
Miriti - Paraná ,Amazonas,456,84,372,Gustavo Petro,84,12,72,0,0,0,0
Puerto Alegría ,Amazonas,264,73,191,Gustavo Petro,72,32,40,0,1,0,1
Puerto Arica ,Amazonas,450,145,305,Gustavo Petro,144,58,84,2,1,0,1
Puerto Nariño,Amazonas,4456,2138,2318,Gustavo Petro,2111,874,1207,30,6,21,27
Puerto Santander ,Amazonas,595,166,429,Gustavo Petro,165,48,115,2,0,1,1
Tarapacá ,Amazonas,1356,432,924,Gustavo Petro,427,146,274,7,2,3,5
Inírida,Guainía,21037,9018,12019,Ivan Duque,8898,5326,3275,297,17,103,120
Barranco Minas ,Guainía,2280,681,1599,Gustavo Petro,675,120,542,13,3,3,6
Mapiripana ,Guainía,650,101,549,Ivan Duque,100,58,41,1,0,1,1
San Felipe ,Guainía,796,241,555,Ivan Duque,236,170,65,1,0,5,5
Puerto Colombia ,Guainía,1142,144,998,Ivan Duque,142,98,43,1,0,2,2
La Guadalupe ,Guainía,184,33,151,Ivan Duque,33,23,9,1,0,0,0
Cacahual ,Guainía,302,23,279,Ivan Duque,23,11,10,2,0,0,0
Pana Pana ,Guainía,362,156,206,Gustavo Petro,155,60,90,5,0,1,1
Morichal ,Guainía,170,31,139,Gustavo Petro,29,7,22,0,0,2,2
San José del Guaviare,Guaviare,39544,20219,19325,Ivan Duque,19758,12101,6601,1056,47,414,461
Calamar,Guaviare,5471,2024,3447,Gustavo Petro,1986,662,1225,99,7,31,38
El Retorno,Guaviare,9278,4260,5018,Ivan Duque,4126,2752,1153,221,17,117,134
Miraflores,Guaviare,4005,1152,2853,Gustavo Petro,1130,239,860,31,4,18,22
Mitú,Vaupés,16148,6518,9630,Gustavo Petro,6461,2445,3898,118,10,47,57
Carurú,Vaupés,1674,670,1004,Gustavo Petro,664,252,406,6,0,6,6
Pacoa ,Vaupés,1129,167,962,Gustavo Petro,166,73,92,1,0,1,1
Taraira,Vaupés,1466,356,1110,Gustavo Petro,356,155,197,4,0,0,0
Papunaua ,Vaupés,103,28,75,Gustavo Petro,28,8,20,0,0,0,0
Yavaraté ,Vaupés,1017,314,703,Ivan Duque,312,161,146,5,0,2,2
Puerto Carreño,Vichada,18553,6608,11945,Ivan Duque,6520,4721,1580,219,13,75,88
La Primavera,Vichada,7116,3229,3887,Ivan Duque,3208,2768,361,79,5,16,21
Santa Rosalía,Vichada,3197,1462,1735,Ivan Duque,1459,1216,210,33,0,3,3
Cumaribo,Vichada,19585,4846,14739,Gustavo Petro,4782,1469,3213,100,13,51,64
Consulados ,Consulados ,812071,259497,552574,Ivan Duque,258848,180948,69553,8347,107,542,649